30 100
GGACGTACTGACTGGTTAGTTGTCGGTAGA|AGATGTGACGATCCGTCACGATCAGCCGCT
CCGTTGCTATTACCGCATAATTTTCAACAA|TGTATGGTCTCATTTATATTCGGGTCCTAG
GTCCTAGCGAGTCTGTTTTTTGCCCACCCC|ATTTTCAACAAAGCGCACGTCCACTACCTG
TTCGGGTCCTAGCGAGTCTGTTTTTTGCCC|TTCTTGCGACCTTCGCAGCAGGAAGCTCAC
CTGGTTAGTTGTCGGTAGAACATGCTGATA|TCCGTCACGATCAGCCGCTGCACCGTGATA
ATTCCGCTACGGGGTCGTATGCACAGACAT|CCCTCAGTTTGACGCGAAATAACTGTATAT
GGTCGTATGCACAGACATTATGTGCGTGCT|CGCGAAATAACTGTATATGTCTTCTCCAAA
TGCGCTTAGGCGGTATGATATCTAGGAGCG|CTGGTTAGTTGTCGGTAGAACATGCTGATA
GCCAGCGATCGGCAGTGACGTTCCTAATCG|AAACCTCCCCTTGACCGTGAGACTGTATCC
TTTTTGCCCACCCCAAAACCTCACACGGCA|ACGTCCACTACCTGCTAATACCAGTTTCCT
TATCACGTTTGGTCAAACGGGCATTACGAT|GGCATTGATCATTCGCTCCCGTTGCCGGGT
CCGGGTCCTAGCGAGTCTGTTTTTTGCCCA|AGTCTGTTTTTTGCCCACCATATCACGTTT
GCGAGTCTGTTTTTTGCCCACTTTTTTGCC|GCCCACCCACGGCGCCGGGTCCTAGCGAGT
GTCCCGGGTCCTAGCGAGTCTGTTTTTTGC|TGGCCACTCTACATGAACCGCGTCAGCTGA
GATCCGTCACGATCAGCCGCTGCACCGTGA|TTTCCCTAGGTCGATCGAGAATCTGAGTCA
TGCGACCTTCGCAGCAGGAAGCTCACAGTT|CCCACACTATCATTCACGATGCAAAAGGCT
GAGTCTGTTTTTTGCCCACCCCAAAACCTC|CAAAGCGCACGTCCACTACCTGCTAATACC
GTCCGGGTCCTAGCGAGTCTGTTTTTTGCC|GGTCCTAGCGAGTCTGTTTTTTGCCCACCT
CACGTATCCCAAAGGAGGAATATAGCGGGT|CGGCGCCAGCGATCGGCAGTGACGTTCCTA
CTAGCGAGTCTGTTTTTTGCCCACACTATC|ATTCCGCTACGGGGTCGTATGCACAGACAT
GAGTCTGTTTTTTGCCCACCCACGGCGCCG|GCCCACCATATCACGTTTGGTCAAACGGGC
GAACCGCGTCAGCTGATCGATTCCGCTACG|TAAGTAAGTTTGCCCATAACCCTCAGTTTG
CTAATCGTAATGCTAATACAAGATGTAGCT|TGTATCCGAATCACGTTACAAGAATAACTG
CGATCCGTCACGATCAGCCGCTGCACCGTG|CTTTCCCTAGGTCGATCGAGAATCTGAGTC
TTTCCGGGTCCTAGCGAGTCTGCGGGTCCT|TTTTTGCCGGGTCCTAGCGAGTCTGTTTTT
TTTGCCCACTTTTTTGCCCACTACTTATAA|CGCCGGGTCCTAGCGAGTCTGTTTTTTGCC
CGTCCGGTGCGAAGCACCGCGAGTCTCGAT|GGCGGTATGATATCTAGGAGCGGGTCCCGG
GTCTGTTTTTTGCCCACTAGCGAGTCTGTT|CCGCGTCAGCTGATCGATTCCGCTACGGGG
GGGTCCTAGCGAGTCTGTTTTTTGCCCACA|CCTAGACAGTGACTTTCGGGTCCTAGCGAG
GGTCCTAGCGAGTCTGTTTTTTGCCCACTT|GTTTTTTGCCCACCCACGGCGCCGGGTCCT
GTCCTAGCGAGTCTGCGGGTCCTAGCGAGT|CGGGTCCTAGCGAGTCTGTTTTTTGCCCAC
TTCATCTACAACGGGTCCTAGCGAGTCTGT|GCTATTACCGCATAATTTTCAACAAAGCGC
CGAGTCTGTTTTTTGCCCACCTCGCCTGAC|AATGCTAATACAAGATGTAGCTCTCTCCGT
GCCGTACCTTGTCCGTTGGCTCGGGTCCTA|CTGTTTTTTGCCCACATGATCTGGATCCAC
GATGTGCGCTTAGGCGGTATGATATCTAGG|CTGACTGGTTAGTTGTCGGTAGAACATGCT
TGAAATCTGAGTACTTTCCGGGTCCTAGCG|CCTAGCGAGTCTGTTTTTTGCCGGGTCCTA
TTTCGGGTCCTAGCGAGTCTGTTTTTTGCC|GTCTGTTTTTTGCCCACTGTTTTTTGCCCA
GATATCTAGGAGCGGGTCCCGGGTCCTAGC|AGAACATGCTGATACTGGCCACTCTACATG
TTTTGCCCACGTACCTGTTAATCGTCCCGC|AAGCTCACAGTTGCTTCGGATACAGGATGT
GCTCCCGTTGCCGGGTCCTAGCGAGTCTGT|CTGTTTTTTGCCCACCCCAAAACCTCACAC
CTGCACTTGTATGGTCTCATTTATATTCGG|AAAGGAAATCTGACATCGACAGAAATTCTT
AGCACCGCGAGTCTCGATGCTGAATGGGTT|TCTAGGAGCGGGTCCCGGGTCCTAGCGAGT
GAAGCTCACAGTTGCTTCGGATACAGGATG|GATGCAAAAGGCTTGCTCCGGACGTACTGA
ATCGACAGAAATTCTTGCGACCTTCGCAGC|CGAGTCTGTTTTTTGCCCACACTATCATTC
TAGCGAGTCTGCGGGTCCTAGCGAGTCTGT|TCCTAGCGAGTCTGTTTTTTGCCCACCCAC
TTTTTGCCGGGTCCTAGCGAGTCTGTTTTT|CTAGCGAGTCTGTTTTTTGCCCACCATATC
CACGGGTCCTAGCGAGTCTGTTTTTTGCCC|TGCCCTAGACAGTGACTTTCGGGTCCTAGC
CTGTTTTTTGCCCACATGCGGCATTGATCA|CCTGACGTTCATCTACAACGGGTCCTAGCG
CATTACGATAACAACTACTAGCCGTATGCC|TTGCCGGGTCCTAGCGAGTCTGTTTTTTGC
CGACCTTCGCAGCAGGAAGCTCACAGTTGC|CACACTATCATTCACGATGCAAAAGGCTTG
TACAACGGGTCCTAGCGAGTCTGTTTTTTG|ACCGCATAATTTTCAACAAAGCGCACGTCC
GCCGTATGCCCTAGACAGTGACTTTCGGGT|TGTTTTTTGCCCACGTATCCCAAAGGAGGA
CTAGCGAGTCTGTTTTTTGCCCACTAGCGA|ACATGAACCGCGTCAGCTGATCGATTCCGC
CCGGGTCCTAGCGAGTCTGTTTTTTGCCCA|TCCTAGCGAGTCTGTTTTTTGCCCACCTCG
ATATCTAGGAGCGGGTCCCGGGTCCTAGCG|GAACATGCTGATACTGGCCACTCTACATGA
TCTCCGTTGCTATTACCGCATAATTTTCAA|ACTTGTATGGTCTCATTTATATTCGGGTCC
AATCTGAGTACTTTCCGGGTCCTAGCGAGT|AGCGAGTCTGTTTTTTGCCGGGTCCTAGCG
TGGTTAGTTGTCGGTAGAACATGCTGATAC|CCGTCACGATCAGCCGCTGCACCGTGATAT
TGCCCACCTCGCCTGACGTTCATCTACAAC|GATGTAGCTCTCTCCGTTGCTATTACCGCA
CGAGTCTGTTTTTTGCCCACGGGTCCTAGC|AACAACTACTAGCCGTATGCCCTAGACAGT
TACTGACTGGTTAGTTGTCGGTAGAACATG|TGACGATCCGTCACGATCAGCCGCTGCACC
CCTTCGCAGCAGGAAGCTCACAGTTGCTTC|ACTATCATTCACGATGCAAAAGGCTTGCTC
TTTTGCCCACGGGTCCTAGCGAGTCTGTTT|AGCCGTATGCCCTAGACAGTGACTTTCGGG
AGTCTGTTTTTTGCCCACTGTTTTTTGCCC|GTTTTTTGCCCACCTCGCCTGACGTTCATC
TTTATATTCGGGTCCTAGCGAGTCTGTTTT|CAGAAATTCTTGCGACCTTCGCAGCAGGAA
CCTAGCGAGTCTGTTTTTTGCCCACATGAT|GACAGTGACTTTCGGGTCCTAGCGAGTCCG
ATAGCGGGTCCTAGCGAGTCTGTTTTTTGC|ACGTTCCTAATCGTAATGCTAATACAAGAT
ACATGCGGCATTGATCATTCGCTCCCGTTG|TACAACGGGTCCTAGCGAGTCTGTTTTTTG
CCATATCACGTTTGGTCAAACGGGCATTAC|TGCGGCATTGATCATTCGCTCCCGTTGCCG
TGCTCCGGACGTACTGACTGGTTAGTTGTC|CTCTCCAGATGTGACGATCCGTCACGATCA
CTTAGGCGGTATGATATCTAGGAGCGGGTC|TTAGTTGTCGGTAGAACATGCTGATACTGG
AGTCCTCTCCAGATGTGACGATCCGTCACG|CGTCCTACTAGTACTTGCCTTTCCCTAGGT
ACCTGCTAATACCAGTTTCCTCTGACTTTA|GCCCACGTACCTGTTAATCGTCCCGCTGCC
GTCAGCTGATCGATTCCGCTACGGGGTCGT|GTTTGCCCATAACCCTCAGTTTGACGCGAA
TAGCGAGTCTGTTTTTTGCCCACGTACCTG|CCTTCGCAGCAGGAAGCTCACAGTTGCTTC
GTTCATCTACAACGGGTCCTAGCGAGTCTG|TGCTATTACCGCATAATTTTCAACAAAGCG
CGTCGGCTGGGCCGTACCTTGTCCGTTGGC|CCTAGCGAGTCTGTTTTTTGCCCACATGAT
CTCACAGTTGCTTCGGATACAGGATGTGCG|CAAAAGGCTTGCTCCGGACGTACTGACTGG
CTAGCGAGTCTGTTTTTTGCCCACATGATC|ACAGTGACTTTCGGGTCCTAGCGAGTCCGG
TGGTCAAACGGGCATTACGATAACAACTAC|CATTCGCTCCCGTTGCCGGGTCCTAGCGAG
GTATCCCAAAGGAGGAATATAGCGGGTCCT|CGCCAGCGATCGGCAGTGACGTTCCTAATC
ACAAGAATAACTGCACTTGTATGGTCTCAT|TGGGTTAGGGAAAGGAAATCTGACATCGAC
CTCCCCTTGACCGTGAGACTGTATCCGAAT|CGTCCGGTGCGAAGCACCGCGAGTCTCGAT
GCTCGGGTCCTAGCGAGTCTGTTTTTTGCC|ATCTGGATCCACTTTTCGGGTCCTAGCGAG
GCCCACTAGCGAGTCTGTTTTTTGCCCACA|GATCGATTCCGCTACGGGGTCGTATGCACA
GTCCGTTGGCTCGGGTCCTAGCGAGTCTGT|CCCACATGATCTGGATCCACTTTTCGGGTC
CCGCTACGGGGTCGTATGCACAGACATTAT|TCAGTTTGACGCGAAATAACTGTATATGTC
TCATTCGCTCCCGTTGCCGGGTCCTAGCGA|GCGAGTCTGTTTTTTGCCCACCCCAAAACC
GTGACGTTCCTAATCGTAATGCTAATACAA|CCGTGAGACTGTATCCGAATCACGTTACAA
TTTTGCCCACTTTTTTGCCCACTACTTATA|GCGCCGGGTCCTAGCGAGTCTGTTTTTTGC
TTTGCCCACGTACCTGTTAATCGTCCCGCT|AGCTCACAGTTGCTTCGGATACAGGATGTG
CTAGCGAGTCTGTTTTTTGCCCACTTTTTT|TTTGCCCACCCACGGCGCCGGGTCCTAGCG
TAGCGAGTCTGTTTTTTGCCGGGTCCTAGC|ACTTTTCGGGTCCTAGCGAGTCTGTTTTTT
CCGCATAATTTTCAACAAAGCGCACGTCCA|TTTATATTCGGGTCCTAGCGAGTCTGTTTT
TAGCGAGTCCGGGTCCTAGCGAGTCTGTTT|ATAGCGGGTCCTAGCGAGTCTGTTTTTTGC
AACCTCCCCTTGACCGTGAGACTGTATCCG|CCGCGTCCGGTGCGAAGCACCGCGAGTCTC
AAAGGCTTGCTCCGGACGTACTGACTGGTT|CTTAGTCCTCTCCAGATGTGACGATCCGTC
GTATGCCCTAGACAGTGACTTTCGGGTCCT|TTTTTGCCCACGTATCCCAAAGGAGGAATA
CATCTACAACGGGTCCTAGCGAGTCTGTTT|TATTACCGCATAATTTTCAACAAAGCGCAC
CTCGATGCTGAATGGGTTAGGGAAAGGAAA|TCCCGGGTCCTAGCGAGTCTGTTTTTTGCC
GTCCACTACCTGCTAATACCAGTTTCCTCT|GTTTTTTGCCCACGTACCTGTTAATCGTCC
TCAAGTGAAATCTGAGTACTTTCCGGGTCC|CGGGTCCTAGCGAGTCTGTTTTTTGCCGGG
TGCCCACTAGCGAGTCTGTTTTTTGCCCAC|TGATCGATTCCGCTACGGGGTCGTATGCAC
TTCAACAAAGCGCACGTCCACTACCTGCTA|GGTCCTAGCGAGTCTGTTTTTTGCCCACGT
TTAAACCTCCCCTTGACCGTGAGACTGTAT|GCCCCGCGTCCGGTGCGAAGCACCGCGAGT
AACATGCTGATACTGGCCACTCTACATGAA|TGCACCGTGATATTAAGAACAATATGCTAA
CGTTGGCTCGGGTCCTAGCGAGTCTGTTTT|ACATGATCTGGATCCACTTTTCGGGTCCTA
CTTCGTCGGCTGGGCCGTACCTTGTCCGTT|GGTCCTAGCGAGTCTGTTTTTTGCCCACAT
TTTGCCCACTACTTATAAGCGCCTTCGTCG|GCGAGTCTGTTTTTTGCCCACGGGTCCTAG
TGCCCACGGGTCCTAGCGAGTCTGTTTTTT|CGTATGCCCTAGACAGTGACTTTCGGGTCC
TGCCCTAGACAGTGACTTTCGGGTCCTAGC|TTGCCCACGTATCCCAAAGGAGGAATATAG
TAGCGAGTCTGTTTTTTGCCCACCATATCA|TGCCCACTGTTTTTTGCCCACATGCGGCAT
GCAGGAAGCTCACAGTTGCTTCGGATACAG|TCACGATGCAAAAGGCTTGCTCCGGACGTA
CAAAGCGCACGTCCACTACCTGCTAATACC|TAGCGAGTCTGTTTTTTGCCCACGTACCTG
TCGTAATGCTAATACAAGATGTAGCTCTCT|TCCGAATCACGTTACAAGAATAACTGCACT
GCACTTGTATGGTCTCATTTATATTCGGGT|AGGAAATCTGACATCGACAGAAATTCTTGC
TTGACCGTGAGACTGTATCCGAATCACGTT|GTGCGAAGCACCGCGAGTCTCGATGCTGAA
TAGACAGTGACTTTCGGGTCCTAGCGAGTC|CACGTATCCCAAAGGAGGAATATAGCGGGT
GAGTCTGTTTTTTGCCCACGTACCTGTTAA|CGCAGCAGGAAGCTCACAGTTGCTTCGGAT
GCGAGTCTGTTTTTTGCCGGGTCCTAGCGA|TTTTCGGGTCCTAGCGAGTCTGTTTTTTGC
AATTTTCAACAAAGCGCACGTCCACTACCT|TTCGGGTCCTAGCGAGTCTGTTTTTTGCCC
TGCTTCGGATACAGGATGTGCGCTTAGGCG|TTGCTCCGGACGTACTGACTGGTTAGTTGT
CCCTAGACAGTGACTTTCGGGTCCTAGCGA|GCCCACGTATCCCAAAGGAGGAATATAGCG
ACCGCATAATTTTCAACAAAGCGCACGTCC|ATTTATATTCGGGTCCTAGCGAGTCTGTTT
CTGATACTGGCCACTCTACATGAACCGCGT|GTGATATTAAGAACAATATGCTAAGTAAGT
CCCCAAAACCTCACACGGCAGGAACGGCGC|CCTGCTAATACCAGTTTCCTCTGACTTTAA
TTTGCCCACTAGCGAGTCTGTTTTTTGCCC|GCTGATCGATTCCGCTACGGGGTCGTATGC
TTACCGCATAATTTTCAACAAAGCGCACGT|TCATTTATATTCGGGTCCTAGCGAGTCTGT
ACGGCGCCAGCGATCGGCAGTGACGTTCCT|ACTTTAAACCTCCCCTTGACCGTGAGACTG
GGGTCCTAGCGAGTCTGTTTTTTGCCCACT|CTAGCGAGTCTGTTTTTTGCCCACCTCGCC
GCTCACAGTTGCTTCGGATACAGGATGTGC|GCAAAAGGCTTGCTCCGGACGTACTGACTG
CCGTACCTTGTCCGTTGGCTCGGGTCCTAG|TGTTTTTTGCCCACATGATCTGGATCCACT
ATCACGTTACAAGAATAACTGCACTTGTAT|ATGCTGAATGGGTTAGGGAAAGGAAATCTG
AGTCTGTTTTTTGCCCACATGATCTGGATC|ACTTTCGGGTCCTAGCGAGTCCGGGTCCTA
TGCCGGGTCCTAGCGAGTCTGTTTTTTGCC|TGCCCACCCCAAAACCTCACACGGCAGGAA
CAGGAACGGCGCCAGCGATCGGCAGTGACG|CTCTGACTTTAAACCTCCCCTTGACCGTGA
GTCTGTTTTTTGCCCACCATATCACGTTTG|CTGTTTTTTGCCCACATGCGGCATTGATCA
ATACTGGCCACTCTACATGAACCGCGTCAG|ATATTAAGAACAATATGCTAAGTAAGTTTG
ACCTTCGCAGCAGGAAGCTCACAGTTGCTT|CACTATCATTCACGATGCAAAAGGCTTGCT
CCACCCCAAAACCTCACACGGCAGGAACGG|CTACCTGCTAATACCAGTTTCCTCTGACTT
GCGCTTAGGCGGTATGATATCTAGGAGCGG|TGGTTAGTTGTCGGTAGAACATGCTGATAC
AGCGAGTCTGTTTTTTGCCCACGTACCTGT|CTTCGCAGCAGGAAGCTCACAGTTGCTTCG
TTTGCCCACACTATCATTCACGATGCAAAA|CGTATGCACAGACATTATGTGCGTGCTCTT
TTTTGCCCACTAGCGAGTCTGTTTTTTGCC|AGCTGATCGATTCCGCTACGGGGTCGTATG
TCTACAACGGGTCCTAGCGAGTCTGTTTTT|TTACCGCATAATTTTCAACAAAGCGCACGT
TTGGCTCGGGTCCTAGCGAGTCTGTTTTTT|ATGATCTGGATCCACTTTTCGGGTCCTAGC
CCAGCGATCGGCAGTGACGTTCCTAATCGT|AACCTCCCCTTGACCGTGAGACTGTATCCG
CTACGGGGTCGTATGCACAGACATTATGTG|GTTTGACGCGAAATAACTGTATATGTCTTC
CGTACCTTGTCCGTTGGCTCGGGTCCTAGC|GTTTTTTGCCCACATGATCTGGATCCACTT
GTCCTAGCGAGTCTGTTTTTTGCCCACTGT|AGCGAGTCTGTTTTTTGCCCACCTCGCCTG
AAATTCTTGCGACCTTCGCAGCAGGAAGCT|TTTTTTGCCCACACTATCATTCACGATGCA
CGAGTCTGTTTTTTGCCCACTGTTTTTTGC|CTGTTTTTTGCCCACCTCGCCTGACGTTCA
TCTGTTTTTTGCCCACGTACCTGTTAATCG|AGCAGGAAGCTCACAGTTGCTTCGGATACA
AATACAAGATGTAGCTCTCTCCGTTGCTAT|GTTACAAGAATAACTGCACTTGTATGGTCT
GTGCGAAGCACCGCGAGTCTCGATGCTGAA|ATGATATCTAGGAGCGGGTCCCGGGTCCTA
CTTTCCGGGTCCTAGCGAGTCTGCGGGTCC|TTTTTTGCCGGGTCCTAGCGAGTCTGTTTT
CCCACCTCGCCTGACGTTCATCTACAACGG|TGTAGCTCTCTCCGTTGCTATTACCGCATA
CTACTTATAAGCGCCTTCGTCGGCTGGGCC|GTTTTTTGCCCACGGGTCCTAGCGAGTCTG
GCCCACGTATCCCAAAGGAGGAATATAGCG|GAACGGCGCCAGCGATCGGCAGTGACGTTC
CATTCGCTCCCGTTGCCGGGTCCTAGCGAG|CGAGTCTGTTTTTTGCCCACCCCAAAACCT
GGGCCGTACCTTGTCCGTTGGCTCGGGTCC|GTCTGTTTTTTGCCCACATGATCTGGATCC
AGGAGCGGGTCCCGGGTCCTAGCGAGTCTG|GCTGATACTGGCCACTCTACATGAACCGCG
CCTTCGTCGGCTGGGCCGTACCTTGTCCGT|GGGTCCTAGCGAGTCTGTTTTTTGCCCACA
TTTTGCCCACGTATCCCAAAGGAGGAATAT|GCAGGAACGGCGCCAGCGATCGGCAGTGAC
CGCATGACCCATAGCGTATTCAAGTGAAAT|CGTACCTTGTCCGTTGGCTCGGGTCCTAGC
GAGTCTGCGGGTCCTAGCGAGTCTGTTTTT|AGCGAGTCTGTTTTTTGCCCACCCACGGCG
TTGCCGGGTCCTAGCGAGTCTGTTTTTTGC|TTGCCCACCCCAAAACCTCACACGGCAGGA
GCGTCCGGTGCGAAGCACCGCGAGTCTCGA|AGGCGGTATGATATCTAGGAGCGGGTCCCG
TTTTTTGCCCACTGTTTTTTGCCCACATGC|TGCCCACCTCGCCTGACGTTCATCTACAAC
CGGGTCCTAGCGAGTCTGTTTTTTGCCCAC|CTTGCGACCTTCGCAGCAGGAAGCTCACAG
CATTATGTGCGTGCTCTTAGTCCTCTCCAG|TATGTCTTCTCCAAACTACGTCCTACTAGT
AGCGAGTCTGCGGGTCCTAGCGAGTCTGTT|CCTAGCGAGTCTGTTTTTTGCCCACCCACG
AATATAGCGGGTCCTAGCGAGTCTGTTTTT|GTGACGTTCCTAATCGTAATGCTAATACAA
GATACAGGATGTGCGCTTAGGCGGTATGAT|GGACGTACTGACTGGTTAGTTGTCGGTAGA
CACCATATCACGTTTGGTCAAACGGGCATT|CATGCGGCATTGATCATTCGCTCCCGTTGC
CTGACTTTAAACCTCCCCTTGACCGTGAGA|CCCGCTGCCCCGCGTCCGGTGCGAAGCACC
CGGGTCCTAGCGAGTCTGTTTTTTGCCCAC|GTCTGTTTTTTGCCCACCATATCACGTTTG
TCTACATGAACCGCGTCAGCTGATCGATTC|AATATGCTAAGTAAGTTTGCCCATAACCCT
AAGATGTAGCTCTCTCCGTTGCTATTACCG|AAGAATAACTGCACTTGTATGGTCTCATTT
GACAGTGACTTTCGGGTCCTAGCGAGTCCG|CGTATCCCAAAGGAGGAATATAGCGGGTCC
GGTCCTAGCGAGTCTGTTTTTTGCCCACGG|ATTACGATAACAACTACTAGCCGTATGCCC
GTTAGGGAAAGGAAATCTGACATCGACAGA|AGTCTGTTTTTTGCCCACTAGCGAGTCTGT
TTTTTTGCCCACACTATCATTCACGATGCA|GGTCGTATGCACAGACATTATGTGCGTGCT
GTTTTTTGCCCACACTATCATTCACGATGC|GGGTCGTATGCACAGACATTATGTGCGTGC
GCTTCGGATACAGGATGTGCGCTTAGGCGG|TGCTCCGGACGTACTGACTGGTTAGTTGTC
CTCTGACTTTAAACCTCCCCTTGACCGTGA|GTCCCGCTGCCCCGCGTCCGGTGCGAAGCA
AACCGCGTCAGCTGATCGATTCCGCTACGG|AAGTAAGTTTGCCCATAACCCTCAGTTTGA
CGGGTCCTAGCGAGTCTGTTTTTTGCCCAC|CACTCTACATGAACCGCGTCAGCTGATCGA
CGGATACAGGATGTGCGCTTAGGCGGTATG|CCGGACGTACTGACTGGTTAGTTGTCGGTA
CGCGTCCGGTGCGAAGCACCGCGAGTCTCG|TAGGCGGTATGATATCTAGGAGCGGGTCCC
TTTTTGCCCACCCACGGCGCCGGGTCCTAG|TATCACGTTTGGTCAAACGGGCATTACGAT
ATCGATTCCGCTACGGGGTCGTATGCACAG|ATAACCCTCAGTTTGACGCGAAATAACTGT
ATCTGAGTACTTTCCGGGTCCTAGCGAGTC|GCGAGTCTGTTTTTTGCCGGGTCCTAGCGA
ATCGTCCCGCTGCCCCGCGTCCGGTGCGAA|TACAGGATGTGCGCTTAGGCGGTATGATAT
CACGTACCTGTTAATCGTCCCGCTGCCCCG|CAGTTGCTTCGGATACAGGATGTGCGCTTA
TCTGTTTTTTGCCCACGGGTCCTAGCGAGT|ACTACTAGCCGTATGCCCTAGACAGTGACT
CGAGTCTGTTTTTTGCCCACATGATCTGGA|TGACTTTCGGGTCCTAGCGAGTCCGGGTCC
AAATCTGACATCGACAGAAATTCTTGCGAC|GCCCACTAGCGAGTCTGTTTTTTGCCCACA
CGGCGCCGGGTCCTAGCGAGTCTGTTTTTT|AAACGGGCATTACGATAACAACTACTAGCC
GGCAGGAACGGCGCCAGCGATCGGCAGTGA|TCCTCTGACTTTAAACCTCCCCTTGACCGT
TTTTTGCCCACTACTTATAAGCGCCTTCGT|TAGCGAGTCTGTTTTTTGCCCACGGGTCCT
TTGCTTCGGATACAGGATGTGCGCTTAGGC|CTTGCTCCGGACGTACTGACTGGTTAGTTG
TTCGCAGCAGGAAGCTCACAGTTGCTTCGG|TATCATTCACGATGCAAAAGGCTTGCTCCG
TATCCGAATCACGTTACAAGAATAACTGCA|AGTCTCGATGCTGAATGGGTTAGGGAAAGG
AGTCTGTTTTTTGCCCACCATATCACGTTT|ACTGTTTTTTGCCCACATGCGGCATTGATC
GAGACTGTATCCGAATCACGTTACAAGAAT|CACCGCGAGTCTCGATGCTGAATGGGTTAG
CATTTATATTCGGGTCCTAGCGAGTCTGTT|GACAGAAATTCTTGCGACCTTCGCAGCAGG
TTATGTGCGTGCTCTTAGTCCTCTCCAGAT|TGTCTTCTCCAAACTACGTCCTACTAGTAC
TAGCCGTATGCCCTAGACAGTGACTTTCGG|TCTGTTTTTTGCCCACGTATCCCAAAGGAG
TTCCTCTGACTTTAAACCTCCCCTTGACCG|ATCGTCCCGCTGCCCCGCGTCCGGTGCGAA
TTAGGCGGTATGATATCTAGGAGCGGGTCC|TAGTTGTCGGTAGAACATGCTGATACTGGC
CATTGATCATTCGCTCCCGTTGCCGGGTCC|GTCCTAGCGAGTCTGTTTTTTGCCCACCCC
TTCTTGCGACCTTCGCAGCAGGAAGCTCAC|TTTGCCCACACTATCATTCACGATGCAAAA
ACTACTAGCCGTATGCCCTAGACAGTGACT|GCGAGTCTGTTTTTTGCCCACGTATCCCAA
ACGGCAGGAACGGCGCCAGCGATCGGCAGT|TTTCCTCTGACTTTAAACCTCCCCTTGACC
CAGCAGGAAGCTCACAGTTGCTTCGGATAC|ATTCACGATGCAAAAGGCTTGCTCCGGACG
TCCCGGGTCCTAGCGAGTCTGTTTTTTGCC|GGCCACTCTACATGAACCGCGTCAGCTGAT
CGTACTGACTGGTTAGTTGTCGGTAGAACA|TGTGACGATCCGTCACGATCAGCCGCTGCA
CCTAGCGAGTCTGTTTTTTGCCCACCTCGC|ATCGTAATGCTAATACAAGATGTAGCTCTC
ACATGCTGATACTGGCCACTCTACATGAAC|GCACCGTGATATTAAGAACAATATGCTAAG
CGGGTCCTAGCGAGTCTGTTTTTTGCCCAC|CTGTTTTTTGCCCACCCACGGCGCCGGGTC
CCTGACGTTCATCTACAACGGGTCCTAGCG|CTCCGTTGCTATTACCGCATAATTTTCAAC
TGCTAATACCAGTTTCCTCTGACTTTAAAC|CACGTACCTGTTAATCGTCCCGCTGCCCCG
CAACAAAGCGCACGTCCACTACCTGCTAAT|TCCTAGCGAGTCTGTTTTTTGCCCACGTAC
TTGCCCACGGGTCCTAGCGAGTCTGTTTTT|CCGTATGCCCTAGACAGTGACTTTCGGGTC
TAGCGAGTCTGTTTTTTGCCCACGGGTCCT|GATAACAACTACTAGCCGTATGCCCTAGAC
GCGAGTCTGTTTTTTGCCCACCCCAAAACC|AACAAAGCGCACGTCCACTACCTGCTAATA
AGCGAGTCTGTTTTTTGCCCACGGGTCCTA|ATAACAACTACTAGCCGTATGCCCTAGACA
TACCTTGTCCGTTGGCTCGGGTCCTAGCGA|TTTTTGCCCACATGATCTGGATCCACTTTT
TAATGCTAATACAAGATGTAGCTCTCTCCG|GAATCACGTTACAAGAATAACTGCACTTGT
GTACTTTCCGGGTCCTAGCGAGTCTGCGGG|CTGTTTTTTGCCGGGTCCTAGCGAGTCTGT
TGACCGTGAGACTGTATCCGAATCACGTTA|TGCGAAGCACCGCGAGTCTCGATGCTGAAT
CCCACCCACGGCGCCGGGTCCTAGCGAGTC|GTTTGGTCAAACGGGCATTACGATAACAAC
GGTCCTAGCGAGTCTGTTTTTTGCCCACCC|AATTTTCAACAAAGCGCACGTCCACTACCT
GCCCACGTACCTGTTAATCGTCCCGCTGCC|TCACAGTTGCTTCGGATACAGGATGTGCGC
AAGCGCACGTCCACTACCTGCTAATACCAG|GCGAGTCTGTTTTTTGCCCACGTACCTGTT
CACGTTACAAGAATAACTGCACTTGTATGG|GCTGAATGGGTTAGGGAAAGGAAATCTGAC
GTCTGCGGGTCCTAGCGAGTCTGTTTTTTG|CGAGTCTGTTTTTTGCCCACCCACGGCGCC
ACGTATCCCAAAGGAGGAATATAGCGGGTC|GGCGCCAGCGATCGGCAGTGACGTTCCTAA
GCCCACATGCGGCATTGATCATTCGCTCCC|CATCTACAACGGGTCCTAGCGAGTCTGTTT
CTAGCGAGTCTGCGGGTCCTAGCGAGTCTG|GTCCTAGCGAGTCTGTTTTTTGCCCACCCA
GTCTGTTTTTTGCCCACACTATCATTCACG|TACGGGGTCGTATGCACAGACATTATGTGC
GTCTGTTTTTTGCCCACTGTTTTTTGCCCA|TTTTTTGCCCACCTCGCCTGACGTTCATCT
TCTGTTTTTTGCCCACCTCGCCTGACGTTC|CTAATACAAGATGTAGCTCTCTCCGTTGCT
CGAGTCTGTTTTTTGCCCACACTATCATTC|CGCTACGGGGTCGTATGCACAGACATTATG
TACCTGCTAATACCAGTTTCCTCTGACTTT|TGCCCACGTACCTGTTAATCGTCCCGCTGC
TCCTAATCGTAATGCTAATACAAGATGTAG|ACTGTATCCGAATCACGTTACAAGAATAAC
TCACGTTTGGTCAAACGGGCATTACGATAA|CATTGATCATTCGCTCCCGTTGCCGGGTCC
GATCCACTTTTCGGGTCCTAGCGAGTCTGT|CCTAGCGAGTCTGTTTTTTGCCCACTGTTT
CTTGCTCCGGACGTACTGACTGGTTAGTTG|TCCTCTCCAGATGTGACGATCCGTCACGAT
GTTTTTTGCCCACCCACGGCGCCGGGTCCT|CATATCACGTTTGGTCAAACGGGCATTACG
TCACGTTACAAGAATAACTGCACTTGTATG|TGCTGAATGGGTTAGGGAAAGGAAATCTGA
TGTTTTTTGCCCACGGGTCCTAGCGAGTCT|TACTAGCCGTATGCCCTAGACAGTGACTTT
GGTCCTAGCGAGTCTGTTTTTTGCCGGGTC|GATCCACTTTTCGGGTCCTAGCGAGTCTGT
GCTGGGCCGTACCTTGTCCGTTGGCTCGGG|CGAGTCTGTTTTTTGCCCACATGATCTGGA
GCGGTATGATATCTAGGAGCGGGTCCCGGG|TGTCGGTAGAACATGCTGATACTGGCCACT
TCGGTAGAACATGCTGATACTGGCCACTCT|CAGCCGCTGCACCGTGATATTAAGAACAAT
GGCGGTATGATATCTAGGAGCGGGTCCCGG|TTGTCGGTAGAACATGCTGATACTGGCCAC
TCCTAGCGAGTCTGTTTTTTGCCCACGGGT|TACGATAACAACTACTAGCCGTATGCCCTA
ACCCATAGCGTATTCAAGTGAAATCTGAGT|TTGTCCGTTGGCTCGGGTCCTAGCGAGTCT
ACCGCGAGTCTCGATGCTGAATGGGTTAGG|AGGAGCGGGTCCCGGGTCCTAGCGAGTCTG
GCGGGTCCTAGCGAGTCTGTTTTTTGCCCA|TTCCTAATCGTAATGCTAATACAAGATGTA
TTTTGCCCACCATATCACGTTTGGTCAAAC|TTGCCCACATGCGGCATTGATCATTCGCTC
TGGGTTAGGGAAAGGAAATCTGACATCGAC|GCGAGTCTGTTTTTTGCCCACTAGCGAGTC
AGCGGGTCCTAGCGAGTCTGTTTTTTGCCC|GTTCCTAATCGTAATGCTAATACAAGATGT
TGACTGGTTAGTTGTCGGTAGAACATGCTG|CGATCCGTCACGATCAGCCGCTGCACCGTG
TCCGGTGCGAAGCACCGCGAGTCTCGATGC|CGGTATGATATCTAGGAGCGGGTCCCGGGT
TCTGTTTTTTGCCCACCATATCACGTTTGG|TGTTTTTTGCCCACATGCGGCATTGATCAT
CGATCGGCAGTGACGTTCCTAATCGTAATG|TCCCCTTGACCGTGAGACTGTATCCGAATC
GTTTTTTGCCCACTGTTTTTTGCCCACATG|TTGCCCACCTCGCCTGACGTTCATCTACAA
TTTTCAACAAAGCGCACGTCCACTACCTGC|CGGGTCCTAGCGAGTCTGTTTTTTGCCCAC
AGACAGTGACTTTCGGGTCCTAGCGAGTCC|ACGTATCCCAAAGGAGGAATATAGCGGGTC
TTGCCCACCCCAAAACCTCACACGGCAGGA|TCCACTACCTGCTAATACCAGTTTCCTCTG
GCGTCAGCTGATCGATTCCGCTACGGGGTC|AAGTTTGCCCATAACCCTCAGTTTGACGCG
GAGTCTGTTTTTTGCCCACTAGCGAGTCTG|AACCGCGTCAGCTGATCGATTCCGCTACGG
CCACTGTTTTTTGCCCACATGCGGCATTGA|TCGCCTGACGTTCATCTACAACGGGTCCTA
TGCCCACACTATCATTCACGATGCAAAAGG|TATGCACAGACATTATGTGCGTGCTCTTAG
GTTTTTTGCCCACCTCGCCTGACGTTCATC|ATACAAGATGTAGCTCTCTCCGTTGCTATT
TACCAGTTTCCTCTGACTTTAAACCTCCCC|CCTGTTAATCGTCCCGCTGCCCCGCGTCCG
CTGTTTTTTGCCCACATGATCTGGATCCAC|TTCGGGTCCTAGCGAGTCCGGGTCCTAGCG
GGGTCCTAGCGAGTCTGTTTTTTGCCGGGT|GGATCCACTTTTCGGGTCCTAGCGAGTCTG
AGCGAGTCTGTTTTTTGCCCACCTCGCCTG|GTAATGCTAATACAAGATGTAGCTCTCTCC
GTTTTTTGCCCACATGCGGCATTGATCATT|TGACGTTCATCTACAACGGGTCCTAGCGAG
CATGCGGCATTGATCATTCGCTCCCGTTGC|ACAACGGGTCCTAGCGAGTCTGTTTTTTGC
TAGCGGGTCCTAGCGAGTCTGTTTTTTGCC|CGTTCCTAATCGTAATGCTAATACAAGATG
ATTCGCTCCCGTTGCCGGGTCCTAGCGAGT|GAGTCTGTTTTTTGCCCACCCCAAAACCTC
CCTAGCGAGTCTGTTTTTTGCCCACTTTTT|TTTTGCCCACCCACGGCGCCGGGTCCTAGC
TCCGCTACGGGGTCGTATGCACAGACATTA|CTCAGTTTGACGCGAAATAACTGTATATGT
CCGTCACGATCAGCCGCTGCACCGTGATAT|CCCTAGGTCGATCGAGAATCTGAGTCACTC
CACGATGCAAAAGGCTTGCTCCGGACGTAC|GTGCGTGCTCTTAGTCCTCTCCAGATGTGA
GTACTGACTGGTTAGTTGTCGGTAGAACAT|GTGACGATCCGTCACGATCAGCCGCTGCAC
TGTTTTTTGCCCACGTACCTGTTAATCGTC|CAGGAAGCTCACAGTTGCTTCGGATACAGG
AGCGAGTCTGTTTTTTGCCCACACTATCAT|TCCGCTACGGGGTCGTATGCACAGACATTA
ATTACGATAACAACTACTAGCCGTATGCCC|TGCCGGGTCCTAGCGAGTCTGTTTTTTGCC
CACCCCAAAACCTCACACGGCAGGAACGGC|TACCTGCTAATACCAGTTTCCTCTGACTTT
ACAACGGGTCCTAGCGAGTCTGTTTTTTGC|CCGCATAATTTTCAACAAAGCGCACGTCCA
CTCCGGACGTACTGACTGGTTAGTTGTCGG|CTCCAGATGTGACGATCCGTCACGATCAGC
ATGACCCATAGCGTATTCAAGTGAAATCTG|ACCTTGTCCGTTGGCTCGGGTCCTAGCGAG
GCGGGTCCCGGGTCCTAGCGAGTCTGTTTT|ATACTGGCCACTCTACATGAACCGCGTCAG
AGGCGGTATGATATCTAGGAGCGGGTCCCG|GTTGTCGGTAGAACATGCTGATACTGGCCA
TAAGCGCCTTCGTCGGCTGGGCCGTACCTT|GCCCACGGGTCCTAGCGAGTCTGTTTTTTG
CAAAACCTCACACGGCAGGAACGGCGCCAG|GCTAATACCAGTTTCCTCTGACTTTAAACC
TTTTTTGCCCACCTCGCCTGACGTTCATCT|TACAAGATGTAGCTCTCTCCGTTGCTATTA
TTTTTTGCCGGGTCCTAGCGAGTCTGTTTT|CCTAGCGAGTCTGTTTTTTGCCCACCATAT
CCTGCTAATACCAGTTTCCTCTGACTTTAA|CCCACGTACCTGTTAATCGTCCCGCTGCCC
CTGTTTTTTGCCCACACTATCATTCACGAT|CGGGGTCGTATGCACAGACATTATGTGCGT
AAAAGGCTTGCTCCGGACGTACTGACTGGT|TCTTAGTCCTCTCCAGATGTGACGATCCGT
ATTCGGGTCCTAGCGAGTCTGTTTTTTGCC|ATTCTTGCGACCTTCGCAGCAGGAAGCTCA
CGTTGCCGGGTCCTAGCGAGTCTGTTTTTT|TTTTGCCCACCCCAAAACCTCACACGGCAG
AGTCTGTTTTTTGCCCACGTACCTGTTAAT|GCAGCAGGAAGCTCACAGTTGCTTCGGATA
CCACGGGTCCTAGCGAGTCTGTTTTTTGCC|ATGCCCTAGACAGTGACTTTCGGGTCCTAG
CGGCTGGGCCGTACCTTGTCCGTTGGCTCG|AGCGAGTCTGTTTTTTGCCCACATGATCTG
CAACGGGTCCTAGCGAGTCTGTTTTTTGCC|CGCATAATTTTCAACAAAGCGCACGTCCAC
TTTTCGGGTCCTAGCGAGTCTGTTTTTTGC|AGTCTGTTTTTTGCCCACTGTTTTTTGCCC
TGTTTTTTGCCCACACTATCATTCACGATG|GGGGTCGTATGCACAGACATTATGTGCGTG
TAATACCAGTTTCCTCTGACTTTAAACCTC|GTACCTGTTAATCGTCCCGCTGCCCCGCGT
CCCACGTACCTGTTAATCGTCCCGCTGCCC|CACAGTTGCTTCGGATACAGGATGTGCGCT
CCCACTGTTTTTTGCCCACATGCGGCATTG|CTCGCCTGACGTTCATCTACAACGGGTCCT
AATCGTAATGCTAATACAAGATGTAGCTCT|TATCCGAATCACGTTACAAGAATAACTGCA
CGGCGCCAGCGATCGGCAGTGACGTTCCTA|CTTTAAACCTCCCCTTGACCGTGAGACTGT
CTGTTTTTTGCCCACGGGTCCTAGCGAGTC|CTACTAGCCGTATGCCCTAGACAGTGACTT
CGAGTCTGTTTTTTGCCCACTTTTTTGCCC|CCCACCCACGGCGCCGGGTCCTAGCGAGTC
TAGCGAGTCTGTTTTTTGCCCACGTATCCC|AAAACCTCACACGGCAGGAACGGCGCCAGC
CGTTACAAGAATAACTGCACTTGTATGGTC|TGAATGGGTTAGGGAAAGGAAATCTGACAT
ACCCCAAAACCTCACACGGCAGGAACGGCG|ACCTGCTAATACCAGTTTCCTCTGACTTTA
CACAGTTGCTTCGGATACAGGATGTGCGCT|AAAGGCTTGCTCCGGACGTACTGACTGGTT
AATGGGTTAGGGAAAGGAAATCTGACATCG|TAGCGAGTCTGTTTTTTGCCCACTAGCGAG
CAGTGACGTTCCTAATCGTAATGCTAATAC|GACCGTGAGACTGTATCCGAATCACGTTAC
AGTGACGTTCCTAATCGTAATGCTAATACA|ACCGTGAGACTGTATCCGAATCACGTTACA
ATACAGGATGTGCGCTTAGGCGGTATGATA|GACGTACTGACTGGTTAGTTGTCGGTAGAA
CTCACACGGCAGGAACGGCGCCAGCGATCG|ACCAGTTTCCTCTGACTTTAAACCTCCCCT
TAATACAAGATGTAGCTCTCTCCGTTGCTA|CGTTACAAGAATAACTGCACTTGTATGGTC
CCCACCATATCACGTTTGGTCAAACGGGCA|CACATGCGGCATTGATCATTCGCTCCCGTT
CGTGCTCTTAGTCCTCTCCAGATGTGACGA|TCCAAACTACGTCCTACTAGTACTTGCCTT
ACGTTACAAGAATAACTGCACTTGTATGGT|CTGAATGGGTTAGGGAAAGGAAATCTGACA
TACAAGATGTAGCTCTCTCCGTTGCTATTA|TACAAGAATAACTGCACTTGTATGGTCTCA
TCCTAGCGAGTCTGTTTTTTGCCCACGTAT|CCCAAAACCTCACACGGCAGGAACGGCGCC
CAGGATGTGCGCTTAGGCGGTATGATATCT|GTACTGACTGGTTAGTTGTCGGTAGAACAT
CGTATCCCAAAGGAGGAATATAGCGGGTCC|GCGCCAGCGATCGGCAGTGACGTTCCTAAT
CTTTTCGGGTCCTAGCGAGTCTGTTTTTTG|GAGTCTGTTTTTTGCCCACTGTTTTTTGCC
TACAGGATGTGCGCTTAGGCGGTATGATAT|ACGTACTGACTGGTTAGTTGTCGGTAGAAC
TTTCCTCTGACTTTAAACCTCCCCTTGACC|AATCGTCCCGCTGCCCCGCGTCCGGTGCGA
GCCACTCTACATGAACCGCGTCAGCTGATC|AGAACAATATGCTAAGTAAGTTTGCCCATA
ACGATCCGTCACGATCAGCCGCTGCACCGT|CCTTTCCCTAGGTCGATCGAGAATCTGAGT
TAGGGAAAGGAAATCTGACATCGACAGAAA|TCTGTTTTTTGCCCACTAGCGAGTCTGTTT
GCCCACGGGTCCTAGCGAGTCTGTTTTTTG|GTATGCCCTAGACAGTGACTTTCGGGTCCT
TCGATTCCGCTACGGGGTCGTATGCACAGA|TAACCCTCAGTTTGACGCGAAATAACTGTA
ATGGGTTAGGGAAAGGAAATCTGACATCGA|AGCGAGTCTGTTTTTTGCCCACTAGCGAGT
TGCCCACTACTTATAAGCGCCTTCGTCGGC|GAGTCTGTTTTTTGCCCACGGGTCCTAGCG
ACTACCTGCTAATACCAGTTTCCTCTGACT|TTTGCCCACGTACCTGTTAATCGTCCCGCT
CCGTGAGACTGTATCCGAATCACGTTACAA|GAAGCACCGCGAGTCTCGATGCTGAATGGG
CCGGGTCCTAGCGAGTCTGTTTTTTGCCCA|GGCATTACGATAACAACTACTAGCCGTATG
GGCGCCGGGTCCTAGCGAGTCTGTTTTTTG|AACGGGCATTACGATAACAACTACTAGCCG
ACGTTCCTAATCGTAATGCTAATACAAGAT|TGAGACTGTATCCGAATCACGTTACAAGAA
GCTAATACAAGATGTAGCTCTCTCCGTTGC|CACGTTACAAGAATAACTGCACTTGTATGG
ATCCGTCACGATCAGCCGCTGCACCGTGAT|TTCCCTAGGTCGATCGAGAATCTGAGTCAC
GCATTGATCATTCGCTCCCGTTGCCGGGTC|GGTCCTAGCGAGTCTGTTTTTTGCCCACCC
GGGCATTACGATAACAACTACTAGCCGTAT|CCGTTGCCGGGTCCTAGCGAGTCTGTTTTT
GTCTGTTTTTTGCCCACGTACCTGTTAATC|CAGCAGGAAGCTCACAGTTGCTTCGGATAC
TTTTGCCCACCCCAAAACCTCACACGGCAG|CGTCCACTACCTGCTAATACCAGTTTCCTC
GCCCACTGTTTTTTGCCCACATGCGGCATT|CCTCGCCTGACGTTCATCTACAACGGGTCC
GAGTCCGGGTCCTAGCGAGTCTGTTTTTTG|CGGGTCCTAGCGAGTCTGTTTTTTGCCCAC
TCCTAGCGAGTCTGTTTTTTGCCCACGTAC|CGACCTTCGCAGCAGGAAGCTCACAGTTGC
AGGGAAAGGAAATCTGACATCGACAGAAAT|CTGTTTTTTGCCCACTAGCGAGTCTGTTTT
GTTGGCTCGGGTCCTAGCGAGTCTGTTTTT|CATGATCTGGATCCACTTTTCGGGTCCTAG
ATGAACCGCGTCAGCTGATCGATTCCGCTA|GCTAAGTAAGTTTGCCCATAACCCTCAGTT
TATCCCAAAGGAGGAATATAGCGGGTCCTA|GCCAGCGATCGGCAGTGACGTTCCTAATCG
CGCCGGGTCCTAGCGAGTCTGTTTTTTGCC|CGGGCATTACGATAACAACTACTAGCCGTA
AGCAGGAAGCTCACAGTTGCTTCGGATACA|TTCACGATGCAAAAGGCTTGCTCCGGACGT
CCACTTTTTTGCCCACTACTTATAAGCGCC|GGTCCTAGCGAGTCTGTTTTTTGCCCACGG
CTCGCCTGACGTTCATCTACAACGGGTCCT|CTCTCTCCGTTGCTATTACCGCATAATTTT
GACAGAAATTCTTGCGACCTTCGCAGCAGG|GTCTGTTTTTTGCCCACACTATCATTCACG
TGTTTTTTGCCCACCCACGGCGCCGGGTCC|CCATATCACGTTTGGTCAAACGGGCATTAC
CCCACATGATCTGGATCCACTTTTCGGGTC|AGCGAGTCCGGGTCCTAGCGAGTCTGTTTT
AGGAAATCTGACATCGACAGAAATTCTTGC|TTTGCCCACTAGCGAGTCTGTTTTTTGCCC
GTCTGTTTTTTGCCCACGGGTCCTAGCGAG|AACTACTAGCCGTATGCCCTAGACAGTGAC
GCTGATACTGGCCACTCTACATGAACCGCG|CGTGATATTAAGAACAATATGCTAAGTAAG
ATTTATATTCGGGTCCTAGCGAGTCTGTTT|ACAGAAATTCTTGCGACCTTCGCAGCAGGA
TTGCCCACATGATCTGGATCCACTTTTCGG|CCTAGCGAGTCCGGGTCCTAGCGAGTCTGT
AGCTCTCTCCGTTGCTATTACCGCATAATT|ACTGCACTTGTATGGTCTCATTTATATTCG
ATGGTCTCATTTATATTCGGGTCCTAGCGA|TGACATCGACAGAAATTCTTGCGACCTTCG
GAAATCTGAGTACTTTCCGGGTCCTAGCGA|CTAGCGAGTCTGTTTTTTGCCGGGTCCTAG
AGACTGTATCCGAATCACGTTACAAGAATA|ACCGCGAGTCTCGATGCTGAATGGGTTAGG
CTGCCCCGCGTCCGGTGCGAAGCACCGCGA|TGCGCTTAGGCGGTATGATATCTAGGAGCG
AACTACTAGCCGTATGCCCTAGACAGTGAC|AGCGAGTCTGTTTTTTGCCCACGTATCCCA
AGTCTGTTTTTTGCCCACCCACGGCGCCGG|CCCACCATATCACGTTTGGTCAAACGGGCA
AGCGTATTCAAGTGAAATCTGAGTACTTTC|GTTGGCTCGGGTCCTAGCGAGTCTGTTTTT
CACCCACGGCGCCGGGTCCTAGCGAGTCTG|TTGGTCAAACGGGCATTACGATAACAACTA
GAAATCTGACATCGACAGAAATTCTTGCGA|TGCCCACTAGCGAGTCTGTTTTTTGCCCAC
TCGACAGAAATTCTTGCGACCTTCGCAGCA|GAGTCTGTTTTTTGCCCACACTATCATTCA
TGTTTTTTGCCCACGTATCCCAAAGGAGGA|CACGGCAGGAACGGCGCCAGCGATCGGCAG
GTCTGTTTTTTGCCCACCTCGCCTGACGTT|GCTAATACAAGATGTAGCTCTCTCCGTTGC
GGGGTCGTATGCACAGACATTATGTGCGTG|GACGCGAAATAACTGTATATGTCTTCTCCA
TCCACTTTTCGGGTCCTAGCGAGTCTGTTT|TAGCGAGTCTGTTTTTTGCCCACTGTTTTT
GCAAAAGGCTTGCTCCGGACGTACTGACTG|GCTCTTAGTCCTCTCCAGATGTGACGATCC
ATCTACAACGGGTCCTAGCGAGTCTGTTTT|ATTACCGCATAATTTTCAACAAAGCGCACG
ATTCACGATGCAAAAGGCTTGCTCCGGACG|TATGTGCGTGCTCTTAGTCCTCTCCAGATG
AGTCTGTTTTTTGCCCACTTTTTTGCCCAC|CACCCACGGCGCCGGGTCCTAGCGAGTCTG
TGTAGCTCTCTCCGTTGCTATTACCGCATA|ATAACTGCACTTGTATGGTCTCATTTATAT
CGGCAGTGACGTTCCTAATCGTAATGCTAA|CTTGACCGTGAGACTGTATCCGAATCACGT
CACTATCATTCACGATGCAAAAGGCTTGCT|CAGACATTATGTGCGTGCTCTTAGTCCTCT
CCTCCCCTTGACCGTGAGACTGTATCCGAA|GCGTCCGGTGCGAAGCACCGCGAGTCTCGA
GTTGCTATTACCGCATAATTTTCAACAAAG|TATGGTCTCATTTATATTCGGGTCCTAGCG
TTTTTGCCCACGGGTCCTAGCGAGTCTGTT|TAGCCGTATGCCCTAGACAGTGACTTTCGG
CTAGCGAGTCTGTTTTTTGCCCACCCCAAA|TTCAACAAAGCGCACGTCCACTACCTGCTA
GGGTCCTAGCGAGTCTGTTTTTTGCCCACG|CATTACGATAACAACTACTAGCCGTATGCC
CTGACATCGACAGAAATTCTTGCGACCTTC|ACTAGCGAGTCTGTTTTTTGCCCACACTAT
CGGGTCCTAGCGAGTCTGTTTTTTGCCCAC|CCCTAGACAGTGACTTTCGGGTCCTAGCGA
GGGTCCTAGCGAGTCTGTTTTTTGCCCACC|TAATTTTCAACAAAGCGCACGTCCACTACC
CGCTCCCGTTGCCGGGTCCTAGCGAGTCTG|TCTGTTTTTTGCCCACCCCAAAACCTCACA
AAAGGAAATCTGACATCGACAGAAATTCTT|TTTTTGCCCACTAGCGAGTCTGTTTTTTGC
ACACTATCATTCACGATGCAAAAGGCTTGC|ACAGACATTATGTGCGTGCTCTTAGTCCTC
ACTATCATTCACGATGCAAAAGGCTTGCTC|AGACATTATGTGCGTGCTCTTAGTCCTCTC
TTTTTTGCCCACATGCGGCATTGATCATTC|GACGTTCATCTACAACGGGTCCTAGCGAGT
TTTTGCCGGGTCCTAGCGAGTCTGTTTTTT|TAGCGAGTCTGTTTTTTGCCCACCATATCA
TGCCCACGTACCTGTTAATCGTCCCGCTGC|CTCACAGTTGCTTCGGATACAGGATGTGCG
TGTTAATCGTCCCGCTGCCCCGCGTCCGGT|TCGGATACAGGATGTGCGCTTAGGCGGTAT
CTTGTATGGTCTCATTTATATTCGGGTCCT|AAATCTGACATCGACAGAAATTCTTGCGAC
GACGTTCCTAATCGTAATGCTAATACAAGA|GTGAGACTGTATCCGAATCACGTTACAAGA
CGGGTCCTAGCGAGTCTGCGGGTCCTAGCG|TGCCGGGTCCTAGCGAGTCTGTTTTTTGCC
TGGCTCGGGTCCTAGCGAGTCTGTTTTTTG|TGATCTGGATCCACTTTTCGGGTCCTAGCG
TTTGCCCACCATATCACGTTTGGTCAAACG|TGCCCACATGCGGCATTGATCATTCGCTCC
GCTCTTAGTCCTCTCCAGATGTGACGATCC|AAACTACGTCCTACTAGTACTTGCCTTTCC
TCGATGCTGAATGGGTTAGGGAAAGGAAAT|CCCGGGTCCTAGCGAGTCTGTTTTTTGCCC
TCTCGATGCTGAATGGGTTAGGGAAAGGAA|GTCCCGGGTCCTAGCGAGTCTGTTTTTTGC
CACATGCGGCATTGATCATTCGCTCCCGTT|CTACAACGGGTCCTAGCGAGTCTGTTTTTT
GTCTCGATGCTGAATGGGTTAGGGAAAGGA|GGTCCCGGGTCCTAGCGAGTCTGTTTTTTG
CGAGTCTGTTTTTTGCCCACTAGCGAGTCT|GAACCGCGTCAGCTGATCGATTCCGCTACG
GAGTCTGTTTTTTGCCGGGTCCTAGCGAGT|TTCGGGTCCTAGCGAGTCTGTTTTTTGCCC
TGCTGAATGGGTTAGGGAAAGGAAATCTGA|GGTCCTAGCGAGTCTGTTTTTTGCCCACTA
GAATGGGTTAGGGAAAGGAAATCTGACATC|CTAGCGAGTCTGTTTTTTGCCCACTAGCGA
CCTAATCGTAATGCTAATACAAGATGTAGC|CTGTATCCGAATCACGTTACAAGAATAACT
GATCGATTCCGCTACGGGGTCGTATGCACA|CATAACCCTCAGTTTGACGCGAAATAACTG
GACATTATGTGCGTGCTCTTAGTCCTCTCC|TATATGTCTTCTCCAAACTACGTCCTACTA
CAGAAATTCTTGCGACCTTCGCAGCAGGAA|CTGTTTTTTGCCCACACTATCATTCACGAT
GTCTGTTTTTTGCCGGGTCCTAGCGAGTCT|CGGGTCCTAGCGAGTCTGTTTTTTGCCCAC
TCTGTTTTTTGCCCACCCCAAAACCTCACA|AGCGCACGTCCACTACCTGCTAATACCAGT
TACTAGCCGTATGCCCTAGACAGTGACTTT|GAGTCTGTTTTTTGCCCACGTATCCCAAAG
CACGGCAGGAACGGCGCCAGCGATCGGCAG|GTTTCCTCTGACTTTAAACCTCCCCTTGAC
GATTCCGCTACGGGGTCGTATGCACAGACA|ACCCTCAGTTTGACGCGAAATAACTGTATA
CTGTTTTTTGCCCACCCACGGCGCCGGGTC|ACCATATCACGTTTGGTCAAACGGGCATTA
AGCGAGTCTGTTTTTTGCCCACTAGCGAGT|ATGAACCGCGTCAGCTGATCGATTCCGCTA
GGGTCCCGGGTCCTAGCGAGTCTGTTTTTT|ACTGGCCACTCTACATGAACCGCGTCAGCT
TCGGGTCCTAGCGAGTCCGGGTCCTAGCGA|GGAGGAATATAGCGGGTCCTAGCGAGTCTG
GTATGCACAGACATTATGTGCGTGCTCTTA|AAATAACTGTATATGTCTTCTCCAAACTAC
TGTTTTTTGCCCACTGTTTTTTGCCCACAT|TTTGCCCACCTCGCCTGACGTTCATCTACA
CGTCCACTACCTGCTAATACCAGTTTCCTC|TGTTTTTTGCCCACGTACCTGTTAATCGTC
CAAAGGAGGAATATAGCGGGTCCTAGCGAG|CGATCGGCAGTGACGTTCCTAATCGTAATG
TTTTTGCCCACATGATCTGGATCCACTTTT|GGTCCTAGCGAGTCCGGGTCCTAGCGAGTC
GTCTGTTTTTTGCCCACGTATCCCAAAGGA|TCACACGGCAGGAACGGCGCCAGCGATCGG
TCCTAGCGAGTCTGTTTTTTGCCCACATGA|AGACAGTGACTTTCGGGTCCTAGCGAGTCC
CGTTCCTAATCGTAATGCTAATACAAGATG|GAGACTGTATCCGAATCACGTTACAAGAAT
CGAGTCTCGATGCTGAATGGGTTAGGGAAA|GCGGGTCCCGGGTCCTAGCGAGTCTGTTTT
CGTCAGCTGATCGATTCCGCTACGGGGTCG|AGTTTGCCCATAACCCTCAGTTTGACGCGA
CGCTACGGGGTCGTATGCACAGACATTATG|CAGTTTGACGCGAAATAACTGTATATGTCT
TTCGCTCCCGTTGCCGGGTCCTAGCGAGTC|AGTCTGTTTTTTGCCCACCCCAAAACCTCA
CTTGCGACCTTCGCAGCAGGAAGCTCACAG|TGCCCACACTATCATTCACGATGCAAAAGG
CCACTAGCGAGTCTGTTTTTTGCCCACACT|TCGATTCCGCTACGGGGTCGTATGCACAGA
CTGTTTTTTGCCCACTAGCGAGTCTGTTTT|GCGTCAGCTGATCGATTCCGCTACGGGGTC
AGTCTCGATGCTGAATGGGTTAGGGAAAGG|GGGTCCCGGGTCCTAGCGAGTCTGTTTTTT
CAACTACTAGCCGTATGCCCTAGACAGTGA|TAGCGAGTCTGTTTTTTGCCCACGTATCCC
AACGGGTCCTAGCGAGTCTGTTTTTTGCCC|GCATAATTTTCAACAAAGCGCACGTCCACT
GCGAGTCTGTTTTTTGCCCACACTATCATT|CCGCTACGGGGTCGTATGCACAGACATTAT
TTTAAACCTCCCCTTGACCGTGAGACTGTA|TGCCCCGCGTCCGGTGCGAAGCACCGCGAG
TCCTAGCGAGTCTGTTTTTTGCCCACTGTT|GCGAGTCTGTTTTTTGCCCACCTCGCCTGA
CGTCACGATCAGCCGCTGCACCGTGATATT|CCTAGGTCGATCGAGAATCTGAGTCACTCA
CCTAGCGAGTCTGTTTTTTGCCCACGGGTC|ACGATAACAACTACTAGCCGTATGCCCTAG
CATCGACAGAAATTCTTGCGACCTTCGCAG|GCGAGTCTGTTTTTTGCCCACACTATCATT
CTAGCGAGTCCGGGTCCTAGCGAGTCTGTT|TATAGCGGGTCCTAGCGAGTCTGTTTTTTG
GTCTGTTTTTTGCCCACTTTTTTGCCCACT|ACCCACGGCGCCGGGTCCTAGCGAGTCTGT
GCCCACTACTTATAAGCGCCTTCGTCGGCT|AGTCTGTTTTTTGCCCACGGGTCCTAGCGA
CTCCGTTGCTATTACCGCATAATTTTCAAC|CTTGTATGGTCTCATTTATATTCGGGTCCT
CATGATCTGGATCCACTTTTCGGGTCCTAG|AGTCCGGGTCCTAGCGAGTCTGTTTTTTGC
ATGCAAAAGGCTTGCTCCGGACGTACTGAC|GTGCTCTTAGTCCTCTCCAGATGTGACGAT
TTTTTTGCCCACGTATCCCAAAGGAGGAAT|CGGCAGGAACGGCGCCAGCGATCGGCAGTG
GTCCTAGCGAGTCTGTTTTTTGCCCACGTA|CCCCAAAACCTCACACGGCAGGAACGGCGC
TCCGGGTCCTAGCGAGTCTGCGGGTCCTAG|TTTGCCGGGTCCTAGCGAGTCTGTTTTTTG
GAGTCTGTTTTTTGCCCACGGGTCCTAGCG|ACAACTACTAGCCGTATGCCCTAGACAGTG
AGCGATCGGCAGTGACGTTCCTAATCGTAA|CCTCCCCTTGACCGTGAGACTGTATCCGAA
GAATCACGTTACAAGAATAACTGCACTTGT|CGATGCTGAATGGGTTAGGGAAAGGAAATC
GATCTGGATCCACTTTTCGGGTCCTAGCGA|CCGGGTCCTAGCGAGTCTGTTTTTTGCCCA
CCCGCTGCCCCGCGTCCGGTGCGAAGCACC|GATGTGCGCTTAGGCGGTATGATATCTAGG
GTTTTTTGCCCACATGATCTGGATCCACTT|CGGGTCCTAGCGAGTCCGGGTCCTAGCGAG
TAGGCGGTATGATATCTAGGAGCGGGTCCC|AGTTGTCGGTAGAACATGCTGATACTGGCC
CCTCACACGGCAGGAACGGCGCCAGCGATC|TACCAGTTTCCTCTGACTTTAAACCTCCCC
GTCGGTAGAACATGCTGATACTGGCCACTC|TCAGCCGCTGCACCGTGATATTAAGAACAA
AGCTCACAGTTGCTTCGGATACAGGATGTG|TGCAAAAGGCTTGCTCCGGACGTACTGACT
TCTCATTTATATTCGGGTCCTAGCGAGTCT|ATCGACAGAAATTCTTGCGACCTTCGCAGC
GGATCCACTTTTCGGGTCCTAGCGAGTCTG|TCCTAGCGAGTCTGTTTTTTGCCCACTGTT
GTTTTTTGCCCACGTACCTGTTAATCGTCC|AGGAAGCTCACAGTTGCTTCGGATACAGGA
TTTTTTGCCCACTACTTATAAGCGCCTTCG|CTAGCGAGTCTGTTTTTTGCCCACGGGTCC
TTTTGCCCACCTCGCCTGACGTTCATCTAC|CAAGATGTAGCTCTCTCCGTTGCTATTACC
TCCGTCACGATCAGCCGCTGCACCGTGATA|TCCCTAGGTCGATCGAGAATCTGAGTCACT
TCCCAAAGGAGGAATATAGCGGGTCCTAGC|CAGCGATCGGCAGTGACGTTCCTAATCGTA
CCTTGACCGTGAGACTGTATCCGAATCACG|CGGTGCGAAGCACCGCGAGTCTCGATGCTG
AATCTGACATCGACAGAAATTCTTGCGACC|CCCACTAGCGAGTCTGTTTTTTGCCCACAC
TCCTAGCGAGTCTGTTTTTTGCCCACCCCA|TTTTCAACAAAGCGCACGTCCACTACCTGC
ACTTTCGGGTCCTAGCGAGTCCGGGTCCTA|CAAAGGAGGAATATAGCGGGTCCTAGCGAG
TCGCCTGACGTTCATCTACAACGGGTCCTA|TCTCTCCGTTGCTATTACCGCATAATTTTC
AGGAATATAGCGGGTCCTAGCGAGTCTGTT|GCAGTGACGTTCCTAATCGTAATGCTAATA
ACGTTTGGTCAAACGGGCATTACGATAACA|TTGATCATTCGCTCCCGTTGCCGGGTCCTA
CACGTCCACTACCTGCTAATACCAGTTTCC|TCTGTTTTTTGCCCACGTACCTGTTAATCG
GGTCTCATTTATATTCGGGTCCTAGCGAGT|ACATCGACAGAAATTCTTGCGACCTTCGCA
AGTCTGTTTTTTGCCGGGTCCTAGCGAGTC|TCGGGTCCTAGCGAGTCTGTTTTTTGCCCA
TCCTAGCGAGTCTGTTTTTTGCCGGGTCCT|TCCACTTTTCGGGTCCTAGCGAGTCTGTTT
TCTGCGGGTCCTAGCGAGTCTGTTTTTTGC|GAGTCTGTTTTTTGCCCACCCACGGCGCCG
TCTGTTTTTTGCCCACATGATCTGGATCCA|TTTCGGGTCCTAGCGAGTCCGGGTCCTAGC
TGGTCTCATTTATATTCGGGTCCTAGCGAG|GACATCGACAGAAATTCTTGCGACCTTCGC
CTGATCGATTCCGCTACGGGGTCGTATGCA|CCCATAACCCTCAGTTTGACGCGAAATAAC
GTCTCATTTATATTCGGGTCCTAGCGAGTC|CATCGACAGAAATTCTTGCGACCTTCGCAG
GACGATCCGTCACGATCAGCCGCTGCACCG|GCCTTTCCCTAGGTCGATCGAGAATCTGAG
CCCACGGGTCCTAGCGAGTCTGTTTTTTGC|TATGCCCTAGACAGTGACTTTCGGGTCCTA
CGGGTCCTAGCGAGTCTGTTTTTTGCCCAC|TCCTAATCGTAATGCTAATACAAGATGTAG
GATAACAACTACTAGCCGTATGCCCTAGAC|GGTCCTAGCGAGTCTGTTTTTTGCCCACGT
TGTTTTTTGCCCACCATATCACGTTTGGTC|TTTTTTGCCCACATGCGGCATTGATCATTC
CCGTTGGCTCGGGTCCTAGCGAGTCTGTTT|CACATGATCTGGATCCACTTTTCGGGTCCT
ATTCTTGCGACCTTCGCAGCAGGAAGCTCA|TTTTGCCCACACTATCATTCACGATGCAAA
ACTGCACTTGTATGGTCTCATTTATATTCG|GAAAGGAAATCTGACATCGACAGAAATTCT
GGGTCCTAGCGAGTCTGTTTTTTGCCCACT|ACTCTACATGAACCGCGTCAGCTGATCGAT
CGCGAGTCTCGATGCTGAATGGGTTAGGGA|GAGCGGGTCCCGGGTCCTAGCGAGTCTGTT
ACGGGTCCTAGCGAGTCTGTTTTTTGCCCA|GCCCTAGACAGTGACTTTCGGGTCCTAGCG
TTGCGACCTTCGCAGCAGGAAGCTCACAGT|GCCCACACTATCATTCACGATGCAAAAGGC
ATGTGCGCTTAGGCGGTATGATATCTAGGA|TGACTGGTTAGTTGTCGGTAGAACATGCTG
AGTGACTTTCGGGTCCTAGCGAGTCCGGGT|ATCCCAAAGGAGGAATATAGCGGGTCCTAG
CGTACCTGTTAATCGTCCCGCTGCCCCGCG|GTTGCTTCGGATACAGGATGTGCGCTTAGG
CGACAGAAATTCTTGCGACCTTCGCAGCAG|AGTCTGTTTTTTGCCCACACTATCATTCAC
AACAACTACTAGCCGTATGCCCTAGACAGT|CCTAGCGAGTCTGTTTTTTGCCCACGTATC
ACCTGTTAATCGTCCCGCTGCCCCGCGTCC|GCTTCGGATACAGGATGTGCGCTTAGGCGG
ATCATTCGCTCCCGTTGCCGGGTCCTAGCG|AGCGAGTCTGTTTTTTGCCCACCCCAAAAC
ACCCACGGCGCCGGGTCCTAGCGAGTCTGT|TGGTCAAACGGGCATTACGATAACAACTAC
AGAACATGCTGATACTGGCCACTCTACATG|GCTGCACCGTGATATTAAGAACAATATGCT
ACGTCCACTACCTGCTAATACCAGTTTCCT|CTGTTTTTTGCCCACGTACCTGTTAATCGT
TGACGATCCGTCACGATCAGCCGCTGCACC|TGCCTTTCCCTAGGTCGATCGAGAATCTGA
CGAGTCTGCGGGTCCTAGCGAGTCTGTTTT|TAGCGAGTCTGTTTTTTGCCCACCCACGGC
CAGACATTATGTGCGTGCTCTTAGTCCTCT|TGTATATGTCTTCTCCAAACTACGTCCTAC
CCTCGCCTGACGTTCATCTACAACGGGTCC|GCTCTCTCCGTTGCTATTACCGCATAATTT
AGGCTTGCTCCGGACGTACTGACTGGTTAG|TAGTCCTCTCCAGATGTGACGATCCGTCAC
GCTAATACCAGTTTCCTCTGACTTTAAACC|ACGTACCTGTTAATCGTCCCGCTGCCCCGC
GTCTGTTTTTTGCCCACATGATCTGGATCC|CTTTCGGGTCCTAGCGAGTCCGGGTCCTAG
TTGCCCACACTATCATTCACGATGCAAAAG|GTATGCACAGACATTATGTGCGTGCTCTTA
CATAGCGTATTCAAGTGAAATCTGAGTACT|TCCGTTGGCTCGGGTCCTAGCGAGTCTGTT
CGGGTCCCGGGTCCTAGCGAGTCTGTTTTT|TACTGGCCACTCTACATGAACCGCGTCAGC
CTAGCGAGTCTGTTTTTTGCCCACGTACCT|ACCTTCGCAGCAGGAAGCTCACAGTTGCTT
CAGTGACTTTCGGGTCCTAGCGAGTCCGGG|TATCCCAAAGGAGGAATATAGCGGGTCCTA
TAACTGCACTTGTATGGTCTCATTTATATT|GGGAAAGGAAATCTGACATCGACAGAAATT
ATGCTGATACTGGCCACTCTACATGAACCG|ACCGTGATATTAAGAACAATATGCTAAGTA
TGCGGCATTGATCATTCGCTCCCGTTGCCG|AACGGGTCCTAGCGAGTCTGTTTTTTGCCC
TCCGGGTCCTAGCGAGTCTGTTTTTTGCCC|GTCCTAGCGAGTCTGTTTTTTGCCCACCTC
GGTCCTAGCGAGTCTGTTTTTTGCCCACTG|TAGCGAGTCTGTTTTTTGCCCACCTCGCCT
ACGTTCATCTACAACGGGTCCTAGCGAGTC|GTTGCTATTACCGCATAATTTTCAACAAAG
TGACATCGACAGAAATTCTTGCGACCTTCG|CTAGCGAGTCTGTTTTTTGCCCACACTATC
CTCATTTATATTCGGGTCCTAGCGAGTCTG|TCGACAGAAATTCTTGCGACCTTCGCAGCA
GCGAGTCTCGATGCTGAATGGGTTAGGGAA|AGCGGGTCCCGGGTCCTAGCGAGTCTGTTT
CTAGCCGTATGCCCTAGACAGTGACTTTCG|GTCTGTTTTTTGCCCACGTATCCCAAAGGA
CCTTGTCCGTTGGCTCGGGTCCTAGCGAGT|TTTGCCCACATGATCTGGATCCACTTTTCG
CAAGATGTAGCTCTCTCCGTTGCTATTACC|CAAGAATAACTGCACTTGTATGGTCTCATT
CCTAGACAGTGACTTTCGGGTCCTAGCGAG|CCCACGTATCCCAAAGGAGGAATATAGCGG
TTAGTCCTCTCCAGATGTGACGATCCGTCA|TACGTCCTACTAGTACTTGCCTTTCCCTAG
GAGTCTGTTTTTTGCCCACTGTTTTTTGCC|TGTTTTTTGCCCACCTCGCCTGACGTTCAT
GTTTTTTGCCCACGTATCCCAAAGGAGGAA|ACGGCAGGAACGGCGCCAGCGATCGGCAGT
GGTTAGTTGTCGGTAGAACATGCTGATACT|CGTCACGATCAGCCGCTGCACCGTGATATT
CGCACGTCCACTACCTGCTAATACCAGTTT|AGTCTGTTTTTTGCCCACGTACCTGTTAAT
ACTAGCGAGTCTGTTTTTTGCCCACACTAT|GATTCCGCTACGGGGTCGTATGCACAGACA
ATGATCTGGATCCACTTTTCGGGTCCTAGC|GTCCGGGTCCTAGCGAGTCTGTTTTTTGCC
TCACGATCAGCCGCTGCACCGTGATATTAA|TAGGTCGATCGAGAATCTGAGTCACTCAAT
TTTTTGCCCACCATATCACGTTTGGTCAAA|TTTGCCCACATGCGGCATTGATCATTCGCT
TACCTGTTAATCGTCCCGCTGCCCCGCGTC|TGCTTCGGATACAGGATGTGCGCTTAGGCG
GAGTCTGTTTTTTGCCCACACTATCATTCA|GCTACGGGGTCGTATGCACAGACATTATGT
CGAGTCTGTTTTTTGCCCACGTATCCCAAA|ACCTCACACGGCAGGAACGGCGCCAGCGAT
GAGTCTGTTTTTTGCCCACCATATCACGTT|CACTGTTTTTTGCCCACATGCGGCATTGAT
TTGCCCACATGCGGCATTGATCATTCGCTC|TTCATCTACAACGGGTCCTAGCGAGTCTGT
CTCTACATGAACCGCGTCAGCTGATCGATT|CAATATGCTAAGTAAGTTTGCCCATAACCC
CGGGTCCTAGCGAGTCTGTTTTTTGCCCAC|CCTAGCGAGTCTGTTTTTTGCCCACCTCGC
CACAGACATTATGTGCGTGCTCTTAGTCCT|ACTGTATATGTCTTCTCCAAACTACGTCCT
GTCCTAGCGAGTCTGTTTTTTGCCCACTAG|TCTACATGAACCGCGTCAGCTGATCGATTC
TTTTTGCCCACTGTTTTTTGCCCACATGCG|GCCCACCTCGCCTGACGTTCATCTACAACG
CTAGCGAGTCTGTTTTTTGCCCACCCACGG|TTTTTGCCCACCATATCACGTTTGGTCAAA
TTGTATGGTCTCATTTATATTCGGGTCCTA|AATCTGACATCGACAGAAATTCTTGCGACC
CTGTTTTTTGCCGGGTCCTAGCGAGTCTGT|GGTCCTAGCGAGTCTGTTTTTTGCCCACCA
GTTACAAGAATAACTGCACTTGTATGGTCT|GAATGGGTTAGGGAAAGGAAATCTGACATC
TTTGGTCAAACGGGCATTACGATAACAACT|ATCATTCGCTCCCGTTGCCGGGTCCTAGCG
AGTTGTCGGTAGAACATGCTGATACTGGCC|ACGATCAGCCGCTGCACCGTGATATTAAGA
TGCCCACTGTTTTTTGCCCACATGCGGCAT|ACCTCGCCTGACGTTCATCTACAACGGGTC
CATGCTGATACTGGCCACTCTACATGAACC|CACCGTGATATTAAGAACAATATGCTAAGT
GGCAGTGACGTTCCTAATCGTAATGCTAAT|TTGACCGTGAGACTGTATCCGAATCACGTT
TGACGTTCCTAATCGTAATGCTAATACAAG|CGTGAGACTGTATCCGAATCACGTTACAAG
TATAGCGGGTCCTAGCGAGTCTGTTTTTTG|GACGTTCCTAATCGTAATGCTAATACAAGA
TTGATCATTCGCTCCCGTTGCCGGGTCCTA|CCTAGCGAGTCTGTTTTTTGCCCACCCCAA
GGTCCTAGCGAGTCTGCGGGTCCTAGCGAG|CCGGGTCCTAGCGAGTCTGTTTTTTGCCCA
CTGTTTTTTGCCCACCCCAAAACCTCACAC|GCGCACGTCCACTACCTGCTAATACCAGTT
TGCCCCGCGTCCGGTGCGAAGCACCGCGAG|GCGCTTAGGCGGTATGATATCTAGGAGCGG
GTTTTTTGCCGGGTCCTAGCGAGTCTGTTT|TCCTAGCGAGTCTGTTTTTTGCCCACCATA
GAGTCTGTTTTTTGCCCACTTTTTTGCCCA|CCACCCACGGCGCCGGGTCCTAGCGAGTCT
TTGCCCACCATATCACGTTTGGTCAAACGG|GCCCACATGCGGCATTGATCATTCGCTCCC
CCTAGCGAGTCTGCGGGTCCTAGCGAGTCT|GGTCCTAGCGAGTCTGTTTTTTGCCCACCC
CTCGGGTCCTAGCGAGTCTGTTTTTTGCCG|TCTGGATCCACTTTTCGGGTCCTAGCGAGT
CTGGGCCGTACCTTGTCCGTTGGCTCGGGT|GAGTCTGTTTTTTGCCCACATGATCTGGAT
ATCCGAATCACGTTACAAGAATAACTGCAC|GTCTCGATGCTGAATGGGTTAGGGAAAGGA
TTGCCCACTGTTTTTTGCCCACATGCGGCA|CACCTCGCCTGACGTTCATCTACAACGGGT
GCTTAGGCGGTATGATATCTAGGAGCGGGT|GTTAGTTGTCGGTAGAACATGCTGATACTG
TTTTTGCCCACGTATCCCAAAGGAGGAATA|GGCAGGAACGGCGCCAGCGATCGGCAGTGA
GCGAAGCACCGCGAGTCTCGATGCTGAATG|GATATCTAGGAGCGGGTCCCGGGTCCTAGC
GAGCGGGTCCCGGGTCCTAGCGAGTCTGTT|TGATACTGGCCACTCTACATGAACCGCGTC
TGTTTTTTGCCCACTTTTTTGCCCACTACT|CACGGCGCCGGGTCCTAGCGAGTCTGTTTT
CTAGCGAGTCTGTTTTTTGCCGGGTCCTAG|CACTTTTCGGGTCCTAGCGAGTCTGTTTTT
GTCCTAGCGAGTCCGGGTCCTAGCGAGTCT|GAATATAGCGGGTCCTAGCGAGTCTGTTTT
AATAACTGCACTTGTATGGTCTCATTTATA|TAGGGAAAGGAAATCTGACATCGACAGAAA
GCGTATTCAAGTGAAATCTGAGTACTTTCC|TTGGCTCGGGTCCTAGCGAGTCTGTTTTTT
GATGTAGCTCTCTCCGTTGCTATTACCGCA|GAATAACTGCACTTGTATGGTCTCATTTAT
AGCGCCTTCGTCGGCTGGGCCGTACCTTGT|CCACGGGTCCTAGCGAGTCTGTTTTTTGCC
TTTTTTGCCCACTTTTTTGCCCACTACTTA|CGGCGCCGGGTCCTAGCGAGTCTGTTTTTT
TCATTCACGATGCAAAAGGCTTGCTCCGGA|ATTATGTGCGTGCTCTTAGTCCTCTCCAGA
TAATCGTCCCGCTGCCCCGCGTCCGGTGCG|GATACAGGATGTGCGCTTAGGCGGTATGAT
TTTTGCCCACTGTTTTTTGCCCACATGCGG|CCCACCTCGCCTGACGTTCATCTACAACGG
CGCATAATTTTCAACAAAGCGCACGTCCAC|TTATATTCGGGTCCTAGCGAGTCTGTTTTT
TGACTTTAAACCTCCCCTTGACCGTGAGAC|CCGCTGCCCCGCGTCCGGTGCGAAGCACCG
CTTCGGATACAGGATGTGCGCTTAGGCGGT|GCTCCGGACGTACTGACTGGTTAGTTGTCG
TTTCAACAAAGCGCACGTCCACTACCTGCT|GGGTCCTAGCGAGTCTGTTTTTTGCCCACG
TCTGTTTTTTGCCCACTGTTTTTTGCCCAC|TTTTTGCCCACCTCGCCTGACGTTCATCTA
GGGTCCTAGCGAGTCCGGGTCCTAGCGAGT|AGGAATATAGCGGGTCCTAGCGAGTCTGTT
TGCCCACCATATCACGTTTGGTCAAACGGG|CCCACATGCGGCATTGATCATTCGCTCCCG
ACGGGTCCTAGCGAGTCTGTTTTTTGCCCA|CATAATTTTCAACAAAGCGCACGTCCACTA
CCACCCACGGCGCCGGGTCCTAGCGAGTCT|TTTGGTCAAACGGGCATTACGATAACAACT
CGGTAGAACATGCTGATACTGGCCACTCTA|AGCCGCTGCACCGTGATATTAAGAACAATA
GGATGTGCGCTTAGGCGGTATGATATCTAG|ACTGACTGGTTAGTTGTCGGTAGAACATGC
AAACGGGCATTACGATAACAACTACTAGCC|GCTCCCGTTGCCGGGTCCTAGCGAGTCTGT
AAGGAAATCTGACATCGACAGAAATTCTTG|TTTTGCCCACTAGCGAGTCTGTTTTTTGCC
ATTCAAGTGAAATCTGAGTACTTTCCGGGT|CTCGGGTCCTAGCGAGTCTGTTTTTTGCCG
CGTGAGACTGTATCCGAATCACGTTACAAG|AAGCACCGCGAGTCTCGATGCTGAATGGGT
GCCCACACTATCATTCACGATGCAAAAGGC|ATGCACAGACATTATGTGCGTGCTCTTAGT
GCGAGTCTGCGGGTCCTAGCGAGTCTGTTT|CTAGCGAGTCTGTTTTTTGCCCACCCACGG
TCACAGTTGCTTCGGATACAGGATGTGCGC|AAAAGGCTTGCTCCGGACGTACTGACTGGT
GCAGTGACGTTCCTAATCGTAATGCTAATA|TGACCGTGAGACTGTATCCGAATCACGTTA
CTGTTTTTTGCCCACTTTTTTGCCCACTAC|CCACGGCGCCGGGTCCTAGCGAGTCTGTTT
GTTCCTAATCGTAATGCTAATACAAGATGT|AGACTGTATCCGAATCACGTTACAAGAATA
CCAAAGGAGGAATATAGCGGGTCCTAGCGA|GCGATCGGCAGTGACGTTCCTAATCGTAAT
GTCCTCTCCAGATGTGACGATCCGTCACGA|GTCCTACTAGTACTTGCCTTTCCCTAGGTC
TCGTCCCGCTGCCCCGCGTCCGGTGCGAAG|ACAGGATGTGCGCTTAGGCGGTATGATATC
GCGAGTCTGTTTTTTGCCCACGGGTCCTAG|TAACAACTACTAGCCGTATGCCCTAGACAG
CGTATGCCCTAGACAGTGACTTTCGGGTCC|TTTTTTGCCCACGTATCCCAAAGGAGGAAT
GCACCGCGAGTCTCGATGCTGAATGGGTTA|CTAGGAGCGGGTCCCGGGTCCTAGCGAGTC
CGATTCCGCTACGGGGTCGTATGCACAGAC|AACCCTCAGTTTGACGCGAAATAACTGTAT
TTTTTGCCCACTAGCGAGTCTGTTTTTTGC|CAGCTGATCGATTCCGCTACGGGGTCGTAT
TCTGTTTTTTGCCCACTAGCGAGTCTGTTT|CGCGTCAGCTGATCGATTCCGCTACGGGGT
GTCCTAGCGAGTCTGTTTTTTGCCGGGTCC|ATCCACTTTTCGGGTCCTAGCGAGTCTGTT
CTTTCGGGTCCTAGCGAGTCCGGGTCCTAG|AAAGGAGGAATATAGCGGGTCCTAGCGAGT
TTTTTGCCCACGTACCTGTTAATCGTCCCG|GAAGCTCACAGTTGCTTCGGATACAGGATG
AGACATTATGTGCGTGCTCTTAGTCCTCTC|GTATATGTCTTCTCCAAACTACGTCCTACT
TTTTTTGCCCACATGATCTGGATCCACTTT|GGGTCCTAGCGAGTCCGGGTCCTAGCGAGT
CCTAGCGAGTCTGTTTTTTGCCCACGTATC|CCAAAACCTCACACGGCAGGAACGGCGCCA
GCCCACATGATCTGGATCCACTTTTCGGGT|TAGCGAGTCCGGGTCCTAGCGAGTCTGTTT
ACGATGCAAAAGGCTTGCTCCGGACGTACT|TGCGTGCTCTTAGTCCTCTCCAGATGTGAC
TTTGCCGGGTCCTAGCGAGTCTGTTTTTTG|AGCGAGTCTGTTTTTTGCCCACCATATCAC
TTTGCCCACGGGTCCTAGCGAGTCTGTTTT|GCCGTATGCCCTAGACAGTGACTTTCGGGT
AGCGCACGTCCACTACCTGCTAATACCAGT|CGAGTCTGTTTTTTGCCCACGTACCTGTTA
ACCTCACACGGCAGGAACGGCGCCAGCGAT|ATACCAGTTTCCTCTGACTTTAAACCTCCC
GCGCCAGCGATCGGCAGTGACGTTCCTAAT|TTAAACCTCCCCTTGACCGTGAGACTGTAT
AAATCTGAGTACTTTCCGGGTCCTAGCGAG|TAGCGAGTCTGTTTTTTGCCGGGTCCTAGC
GCCCCGCGTCCGGTGCGAAGCACCGCGAGT|CGCTTAGGCGGTATGATATCTAGGAGCGGG
AGCGGGTCCCGGGTCCTAGCGAGTCTGTTT|GATACTGGCCACTCTACATGAACCGCGTCA
CTGTTTTTTGCCCACGTACCTGTTAATCGT|GCAGGAAGCTCACAGTTGCTTCGGATACAG
TTTTGCCCACATGATCTGGATCCACTTTTC|GTCCTAGCGAGTCCGGGTCCTAGCGAGTCT
TACATGAACCGCGTCAGCTGATCGATTCCG|TATGCTAAGTAAGTTTGCCCATAACCCTCA
TGCCCACGTATCCCAAAGGAGGAATATAGC|GGAACGGCGCCAGCGATCGGCAGTGACGTT
CCTAGCGAGTCTGTTTTTTGCCCACTGTTT|CGAGTCTGTTTTTTGCCCACCTCGCCTGAC
GGTCCTAGCGAGTCTGTTTTTTGCCCACAT|CTAGACAGTGACTTTCGGGTCCTAGCGAGT
CCACCTCGCCTGACGTTCATCTACAACGGG|GTAGCTCTCTCCGTTGCTATTACCGCATAA
ATCCACTTTTCGGGTCCTAGCGAGTCTGTT|CTAGCGAGTCTGTTTTTTGCCCACTGTTTT
AGTCTGCGGGTCCTAGCGAGTCTGTTTTTT|GCGAGTCTGTTTTTTGCCCACCCACGGCGC
TTTGCCCACCCACGGCGCCGGGTCCTAGCG|TCACGTTTGGTCAAACGGGCATTACGATAA
TTTTTTGCCCACCCCAAAACCTCACACGGC|CACGTCCACTACCTGCTAATACCAGTTTCC
CACTTTTCGGGTCCTAGCGAGTCTGTTTTT|GCGAGTCTGTTTTTTGCCCACTGTTTTTTG
CACATGATCTGGATCCACTTTTCGGGTCCT|CGAGTCCGGGTCCTAGCGAGTCTGTTTTTT
TGTGACGATCCGTCACGATCAGCCGCTGCA|CTTGCCTTTCCCTAGGTCGATCGAGAATCT
AGTCTGTTTTTTGCCCACGGGTCCTAGCGA|CAACTACTAGCCGTATGCCCTAGACAGTGA
GGCCGTACCTTGTCCGTTGGCTCGGGTCCT|TCTGTTTTTTGCCCACATGATCTGGATCCA
TGGGCCGTACCTTGTCCGTTGGCTCGGGTC|AGTCTGTTTTTTGCCCACATGATCTGGATC
GCCTTCGTCGGCTGGGCCGTACCTTGTCCG|CGGGTCCTAGCGAGTCTGTTTTTTGCCCAC
TCGGATACAGGATGTGCGCTTAGGCGGTAT|TCCGGACGTACTGACTGGTTAGTTGTCGGT
TATGATATCTAGGAGCGGGTCCCGGGTCCT|GGTAGAACATGCTGATACTGGCCACTCTAC
CCCACACTATCATTCACGATGCAAAAGGCT|TGCACAGACATTATGTGCGTGCTCTTAGTC
TCCTAGCGAGTCTGTTTTTTGCCCACTTTT|TTTTTGCCCACCCACGGCGCCGGGTCCTAG
GTGCGTGCTCTTAGTCCTCTCCAGATGTGA|TTCTCCAAACTACGTCCTACTAGTACTTGC
AGCGAGTCTGTTTTTTGCCCACCCCAAAAC|CAACAAAGCGCACGTCCACTACCTGCTAAT
ACCAGTTTCCTCTGACTTTAAACCTCCCCT|CTGTTAATCGTCCCGCTGCCCCGCGTCCGG
TGCCCACATGCGGCATTGATCATTCGCTCC|TCATCTACAACGGGTCCTAGCGAGTCTGTT
ATCATTCACGATGCAAAAGGCTTGCTCCGG|CATTATGTGCGTGCTCTTAGTCCTCTCCAG
GGTATGATATCTAGGAGCGGGTCCCGGGTC|TCGGTAGAACATGCTGATACTGGCCACTCT
ACGGGGTCGTATGCACAGACATTATGTGCG|TTGACGCGAAATAACTGTATATGTCTTCTC
TCCTCTGACTTTAAACCTCCCCTTGACCGT|TCGTCCCGCTGCCCCGCGTCCGGTGCGAAG
AAGGCTTGCTCCGGACGTACTGACTGGTTA|TTAGTCCTCTCCAGATGTGACGATCCGTCA
GCCCACTTTTTTGCCCACTACTTATAAGCG|CGGGTCCTAGCGAGTCTGTTTTTTGCCCAC
TCCTAGCGAGTCCGGGTCCTAGCGAGTCTG|AATATAGCGGGTCCTAGCGAGTCTGTTTTT
CGAATCACGTTACAAGAATAACTGCACTTG|TCGATGCTGAATGGGTTAGGGAAAGGAAAT
ATTATGTGCGTGCTCTTAGTCCTCTCCAGA|ATGTCTTCTCCAAACTACGTCCTACTAGTA
GTCCTAGCGAGTCTGTTTTTTGCCCACCAT|TTTTTGCCCACTGTTTTTTGCCCACATGCG
TTTGCCCACTGTTTTTTGCCCACATGCGGC|CCACCTCGCCTGACGTTCATCTACAACGGG
ACAAAGCGCACGTCCACTACCTGCTAATAC|CTAGCGAGTCTGTTTTTTGCCCACGTACCT
TACGATAACAACTACTAGCCGTATGCCCTA|CCGGGTCCTAGCGAGTCTGTTTTTTGCCCA
CGGGTCCTAGCGAGTCTGTTTTTTGCCCAC|CCACCCCAAAACCTCACACGGCAGGAACGG
ATTACCGCATAATTTTCAACAAAGCGCACG|CTCATTTATATTCGGGTCCTAGCGAGTCTG
CGCGTCAGCTGATCGATTCCGCTACGGGGT|TAAGTTTGCCCATAACCCTCAGTTTGACGC
ACTAGCCGTATGCCCTAGACAGTGACTTTC|AGTCTGTTTTTTGCCCACGTATCCCAAAGG
GGTCCTAGCGAGTCTGTTTTTTGCCCACTA|CTCTACATGAACCGCGTCAGCTGATCGATT
GTGAGACTGTATCCGAATCACGTTACAAGA|AGCACCGCGAGTCTCGATGCTGAATGGGTT
TGATCTGGATCCACTTTTCGGGTCCTAGCG|TCCGGGTCCTAGCGAGTCTGTTTTTTGCCC
AATGCTAATACAAGATGTAGCTCTCTCCGT|AATCACGTTACAAGAATAACTGCACTTGTA
GTGCTCTTAGTCCTCTCCAGATGTGACGAT|CCAAACTACGTCCTACTAGTACTTGCCTTT
CCCTTGACCGTGAGACTGTATCCGAATCAC|CCGGTGCGAAGCACCGCGAGTCTCGATGCT
CCTAGCGAGTCTGTTTTTTGCCGGGTCCTA|CCACTTTTCGGGTCCTAGCGAGTCTGTTTT
TGTGCGCTTAGGCGGTATGATATCTAGGAG|GACTGGTTAGTTGTCGGTAGAACATGCTGA
TTTGCCCACCTCGCCTGACGTTCATCTACA|AAGATGTAGCTCTCTCCGTTGCTATTACCG
TCCGAATCACGTTACAAGAATAACTGCACT|TCTCGATGCTGAATGGGTTAGGGAAAGGAA
TCTGGATCCACTTTTCGGGTCCTAGCGAGT|GGGTCCTAGCGAGTCTGTTTTTTGCCCACT
ACATCGACAGAAATTCTTGCGACCTTCGCA|AGCGAGTCTGTTTTTTGCCCACACTATCAT
GATACTGGCCACTCTACATGAACCGCGTCA|GATATTAAGAACAATATGCTAAGTAAGTTT
AACGGCGCCAGCGATCGGCAGTGACGTTCC|GACTTTAAACCTCCCCTTGACCGTGAGACT
TCGGCAGTGACGTTCCTAATCGTAATGCTA|CCTTGACCGTGAGACTGTATCCGAATCACG
CTACCTGCTAATACCAGTTTCCTCTGACTT|TTGCCCACGTACCTGTTAATCGTCCCGCTG
TGCTCTTAGTCCTCTCCAGATGTGACGATC|CAAACTACGTCCTACTAGTACTTGCCTTTC
GCTTGCTCCGGACGTACTGACTGGTTAGTT|GTCCTCTCCAGATGTGACGATCCGTCACGA
CCCACCCCAAAACCTCACACGGCAGGAACG|ACTACCTGCTAATACCAGTTTCCTCTGACT
TCTGACTTTAAACCTCCCCTTGACCGTGAG|TCCCGCTGCCCCGCGTCCGGTGCGAAGCAC
AAGCACCGCGAGTCTCGATGCTGAATGGGT|ATCTAGGAGCGGGTCCCGGGTCCTAGCGAG
TTTTGCCCACCCACGGCGCCGGGTCCTAGC|ATCACGTTTGGTCAAACGGGCATTACGATA
CGATAACAACTACTAGCCGTATGCCCTAGA|GGGTCCTAGCGAGTCTGTTTTTTGCCCACG
TTGCCCACGTACCTGTTAATCGTCCCGCTG|GCTCACAGTTGCTTCGGATACAGGATGTGC
GGCGCCAGCGATCGGCAGTGACGTTCCTAA|TTTAAACCTCCCCTTGACCGTGAGACTGTA
CTCTCCAGATGTGACGATCCGTCACGATCA|CTACTAGTACTTGCCTTTCCCTAGGTCGAT
ATGTAGCTCTCTCCGTTGCTATTACCGCAT|AATAACTGCACTTGTATGGTCTCATTTATA
GAAAGGAAATCTGACATCGACAGAAATTCT|TTTTTTGCCCACTAGCGAGTCTGTTTTTTG
GTACCTGTTAATCGTCCCGCTGCCCCGCGT|TTGCTTCGGATACAGGATGTGCGCTTAGGC
GGGTCCTAGCGAGTCTGTTTTTTGCCCACC|CCTAATCGTAATGCTAATACAAGATGTAGC
CGTTCATCTACAACGGGTCCTAGCGAGTCT|TTGCTATTACCGCATAATTTTCAACAAAGC
ATAACTGCACTTGTATGGTCTCATTTATAT|AGGGAAAGGAAATCTGACATCGACAGAAAT
ATGCTGAATGGGTTAGGGAAAGGAAATCTG|GGGTCCTAGCGAGTCTGTTTTTTGCCCACT
CCTAGCGAGTCTGTTTTTTGCCCACTAGCG|TACATGAACCGCGTCAGCTGATCGATTCCG
TAATTTTCAACAAAGCGCACGTCCACTACC|ATTCGGGTCCTAGCGAGTCTGTTTTTTGCC
TCATTTATATTCGGGTCCTAGCGAGTCTGT|CGACAGAAATTCTTGCGACCTTCGCAGCAG
GGAAATCTGACATCGACAGAAATTCTTGCG|TTGCCCACTAGCGAGTCTGTTTTTTGCCCA
TGACCCATAGCGTATTCAAGTGAAATCTGA|CCTTGTCCGTTGGCTCGGGTCCTAGCGAGT
AAAGCGCACGTCCACTACCTGCTAATACCA|AGCGAGTCTGTTTTTTGCCCACGTACCTGT
TGCCCACCCACGGCGCCGGGTCCTAGCGAG|ACGTTTGGTCAAACGGGCATTACGATAACA
GCGAGTCTGTTTTTTGCCCACCCACGGCGC|TTGCCCACCATATCACGTTTGGTCAAACGG
TGTCCGTTGGCTCGGGTCCTAGCGAGTCTG|GCCCACATGATCTGGATCCACTTTTCGGGT
CCGGACGTACTGACTGGTTAGTTGTCGGTA|CCAGATGTGACGATCCGTCACGATCAGCCG
TTTTTTGCCCACGTACCTGTTAATCGTCCC|GGAAGCTCACAGTTGCTTCGGATACAGGAT
GACGTTCATCTACAACGGGTCCTAGCGAGT|CGTTGCTATTACCGCATAATTTTCAACAAA
CTGTTTTTTGCCCACTGTTTTTTGCCCACA|TTTTGCCCACCTCGCCTGACGTTCATCTAC
TAGAACATGCTGATACTGGCCACTCTACAT|CGCTGCACCGTGATATTAAGAACAATATGC
GGAACGGCGCCAGCGATCGGCAGTGACGTT|CTGACTTTAAACCTCCCCTTGACCGTGAGA
GGCATTGATCATTCGCTCCCGTTGCCGGGT|GGGTCCTAGCGAGTCTGTTTTTTGCCCACC
CCACCATATCACGTTTGGTCAAACGGGCAT|ACATGCGGCATTGATCATTCGCTCCCGTTG
TCTGTTTTTTGCCGGGTCCTAGCGAGTCTG|GGGTCCTAGCGAGTCTGTTTTTTGCCCACC
TCCTAGCGAGTCTGTTTTTTGCCCACTAGC|CTACATGAACCGCGTCAGCTGATCGATTCC
ACGTACCTGTTAATCGTCCCGCTGCCCCGC|AGTTGCTTCGGATACAGGATGTGCGCTTAG
TGCACAGACATTATGTGCGTGCTCTTAGTC|TAACTGTATATGTCTTCTCCAAACTACGTC
ATGCACAGACATTATGTGCGTGCTCTTAGT|ATAACTGTATATGTCTTCTCCAAACTACGT
GTTTGGTCAAACGGGCATTACGATAACAAC|GATCATTCGCTCCCGTTGCCGGGTCCTAGC
CCCACTACTTATAAGCGCCTTCGTCGGCTG|GTCTGTTTTTTGCCCACGGGTCCTAGCGAG
TCTGAGTACTTTCCGGGTCCTAGCGAGTCT|CGAGTCTGTTTTTTGCCGGGTCCTAGCGAG
TGCACTTGTATGGTCTCATTTATATTCGGG|AAGGAAATCTGACATCGACAGAAATTCTTG
CCACGGCGCCGGGTCCTAGCGAGTCTGTTT|GTCAAACGGGCATTACGATAACAACTACTA
TGTTTTTTGCCCACATGCGGCATTGATCAT|CTGACGTTCATCTACAACGGGTCCTAGCGA
TAGGAGCGGGTCCCGGGTCCTAGCGAGTCT|TGCTGATACTGGCCACTCTACATGAACCGC
AATCACGTTACAAGAATAACTGCACTTGTA|GATGCTGAATGGGTTAGGGAAAGGAAATCT
GGTAGAACATGCTGATACTGGCCACTCTAC|GCCGCTGCACCGTGATATTAAGAACAATAT
GGAAGCTCACAGTTGCTTCGGATACAGGAT|CGATGCAAAAGGCTTGCTCCGGACGTACTG
CACCGCGAGTCTCGATGCTGAATGGGTTAG|TAGGAGCGGGTCCCGGGTCCTAGCGAGTCT
TGATATCTAGGAGCGGGTCCCGGGTCCTAG|TAGAACATGCTGATACTGGCCACTCTACAT
GTAGCTCTCTCCGTTGCTATTACCGCATAA|TAACTGCACTTGTATGGTCTCATTTATATT
GCGAGTCTGTTTTTTGCCCACCTCGCCTGA|TAATGCTAATACAAGATGTAGCTCTCTCCG
TCGGGTCCTAGCGAGTCTGTTTTTTGCCCA|TCTTGCGACCTTCGCAGCAGGAAGCTCACA
ACGTACTGACTGGTTAGTTGTCGGTAGAAC|ATGTGACGATCCGTCACGATCAGCCGCTGC
CTTAGTCCTCTCCAGATGTGACGATCCGTC|CTACGTCCTACTAGTACTTGCCTTTCCCTA
CGGGTCCTAGCGAGTCTGTTTTTTGCCCAC|GCATTACGATAACAACTACTAGCCGTATGC
TAATCGTAATGCTAATACAAGATGTAGCTC|GTATCCGAATCACGTTACAAGAATAACTGC
GTCTGTTTTTTGCCCACCCCAAAACCTCAC|AAGCGCACGTCCACTACCTGCTAATACCAG
ACTACTTATAAGCGCCTTCGTCGGCTGGGC|TGTTTTTTGCCCACGGGTCCTAGCGAGTCT
CATGACCCATAGCGTATTCAAGTGAAATCT|TACCTTGTCCGTTGGCTCGGGTCCTAGCGA
ACTTTTCGGGTCCTAGCGAGTCTGTTTTTT|CGAGTCTGTTTTTTGCCCACTGTTTTTTGC
GGATACAGGATGTGCGCTTAGGCGGTATGA|CGGACGTACTGACTGGTTAGTTGTCGGTAG
GTAATGCTAATACAAGATGTAGCTCTCTCC|CGAATCACGTTACAAGAATAACTGCACTTG
CCAAAACCTCACACGGCAGGAACGGCGCCA|TGCTAATACCAGTTTCCTCTGACTTTAAAC
GCAGGAACGGCGCCAGCGATCGGCAGTGAC|CCTCTGACTTTAAACCTCCCCTTGACCGTG
GTCCTAGCGAGTCTGTTTTTTGCCCACCTC|TAATCGTAATGCTAATACAAGATGTAGCTC
TTTTGCCCACATGCGGCATTGATCATTCGC|CGTTCATCTACAACGGGTCCTAGCGAGTCT
CTAGACAGTGACTTTCGGGTCCTAGCGAGT|CCACGTATCCCAAAGGAGGAATATAGCGGG
TCCCGTTGCCGGGTCCTAGCGAGTCTGTTT|GTTTTTTGCCCACCCCAAAACCTCACACGG
GAAATTCTTGCGACCTTCGCAGCAGGAAGC|GTTTTTTGCCCACACTATCATTCACGATGC
CGGGCATTACGATAACAACTACTAGCCGTA|CCCGTTGCCGGGTCCTAGCGAGTCTGTTTT
GCCGGGTCCTAGCGAGTCTGTTTTTTGCCC|GAGTCTGTTTTTTGCCCACCATATCACGTT
GGTCCTAGCGAGTCTGTTTTTTGCCCACCT|CTAATCGTAATGCTAATACAAGATGTAGCT
CGCTTAGGCGGTATGATATCTAGGAGCGGG|GGTTAGTTGTCGGTAGAACATGCTGATACT
CCCACGGCGCCGGGTCCTAGCGAGTCTGTT|GGTCAAACGGGCATTACGATAACAACTACT
TAGCGAGTCTGTTTTTTGCCCACTAGCGAG|CATGAACCGCGTCAGCTGATCGATTCCGCT
GGGAAAGGAAATCTGACATCGACAGAAATT|TGTTTTTTGCCCACTAGCGAGTCTGTTTTT
CGCCTTCGTCGGCTGGGCCGTACCTTGTCC|ACGGGTCCTAGCGAGTCTGTTTTTTGCCCA
CTGGCCACTCTACATGAACCGCGTCAGCTG|TTAAGAACAATATGCTAAGTAAGTTTGCCC
GGTCCCGGGTCCTAGCGAGTCTGTTTTTTG|CTGGCCACTCTACATGAACCGCGTCAGCTG
GAGTCTGTTTTTTGCCCACATGATCTGGAT|GACTTTCGGGTCCTAGCGAGTCCGGGTCCT
CTCTCCGTTGCTATTACCGCATAATTTTCA|CACTTGTATGGTCTCATTTATATTCGGGTC
TCCACTACCTGCTAATACCAGTTTCCTCTG|TTTTTTGCCCACGTACCTGTTAATCGTCCC
TAGTTGTCGGTAGAACATGCTGATACTGGC|CACGATCAGCCGCTGCACCGTGATATTAAG
CGGGTCCTAGCGAGTCCGGGTCCTAGCGAG|GAGGAATATAGCGGGTCCTAGCGAGTCTGT
GATCATTCGCTCCCGTTGCCGGGTCCTAGC|TAGCGAGTCTGTTTTTTGCCCACCCCAAAA
CTGTATCCGAATCACGTTACAAGAATAACT|GCGAGTCTCGATGCTGAATGGGTTAGGGAA
TGTTTTTTGCCCACATGATCTGGATCCACT|TCGGGTCCTAGCGAGTCCGGGTCCTAGCGA
TTTGCCCACGTATCCCAAAGGAGGAATATA|CAGGAACGGCGCCAGCGATCGGCAGTGACG
GACTGGTTAGTTGTCGGTAGAACATGCTGA|GATCCGTCACGATCAGCCGCTGCACCGTGA
TCCGTTGCTATTACCGCATAATTTTCAACA|TTGTATGGTCTCATTTATATTCGGGTCCTA
TACTTATAAGCGCCTTCGTCGGCTGGGCCG|TTTTTTGCCCACGGGTCCTAGCGAGTCTGT
GTCGTATGCACAGACATTATGTGCGTGCTC|GCGAAATAACTGTATATGTCTTCTCCAAAC
TAGCGAGTCTGTTTTTTGCCCACTTTTTTG|TTGCCCACCCACGGCGCCGGGTCCTAGCGA
CTACTAGCCGTATGCCCTAGACAGTGACTT|CGAGTCTGTTTTTTGCCCACGTATCCCAAA
CAAGTGAAATCTGAGTACTTTCCGGGTCCT|GGGTCCTAGCGAGTCTGTTTTTTGCCGGGT
CAAAAGGCTTGCTCCGGACGTACTGACTGG|CTCTTAGTCCTCTCCAGATGTGACGATCCG
GGGTCCTAGCGAGTCTGTTTTTTGCCCACC|TCTGTTTTTTGCCCACCATATCACGTTTGG
AGTTGCTTCGGATACAGGATGTGCGCTTAG|GGCTTGCTCCGGACGTACTGACTGGTTAGT
TCTGTTTTTTGCCCACCCACGGCGCCGGGT|CACCATATCACGTTTGGTCAAACGGGCATT
CCCAAAACCTCACACGGCAGGAACGGCGCC|CTGCTAATACCAGTTTCCTCTGACTTTAAA
CCCCGCGTCCGGTGCGAAGCACCGCGAGTC|GCTTAGGCGGTATGATATCTAGGAGCGGGT
GAATATAGCGGGTCCTAGCGAGTCTGTTTT|AGTGACGTTCCTAATCGTAATGCTAATACA
GTTAATCGTCCCGCTGCCCCGCGTCCGGTG|CGGATACAGGATGTGCGCTTAGGCGGTATG
TCGTATGCACAGACATTATGTGCGTGCTCT|CGAAATAACTGTATATGTCTTCTCCAAACT
CGGCAGGAACGGCGCCAGCGATCGGCAGTG|TTCCTCTGACTTTAAACCTCCCCTTGACCG
TGTATCCGAATCACGTTACAAGAATAACTG|CGAGTCTCGATGCTGAATGGGTTAGGGAAA
GCTCCGGACGTACTGACTGGTTAGTTGTCG|TCTCCAGATGTGACGATCCGTCACGATCAG
GCGAGTCTGTTTTTTGCCCACCATATCACG|CCCACTGTTTTTTGCCCACATGCGGCATTG
AGCGAGTCTGTTTTTTGCCGGGTCCTAGCG|CTTTTCGGGTCCTAGCGAGTCTGTTTTTTG
TTAGGGAAAGGAAATCTGACATCGACAGAA|GTCTGTTTTTTGCCCACTAGCGAGTCTGTT
GCCCACCTCGCCTGACGTTCATCTACAACG|ATGTAGCTCTCTCCGTTGCTATTACCGCAT
CTCCCGTTGCCGGGTCCTAGCGAGTCTGTT|TGTTTTTTGCCCACCCCAAAACCTCACACG
AAGCTCACAGTTGCTTCGGATACAGGATGT|ATGCAAAAGGCTTGCTCCGGACGTACTGAC
TCCCGCTGCCCCGCGTCCGGTGCGAAGCAC|GGATGTGCGCTTAGGCGGTATGATATCTAG
CTCTTAGTCCTCTCCAGATGTGACGATCCG|AACTACGTCCTACTAGTACTTGCCTTTCCC
TGCCGGGTCCTAGCGAGTCTGTTTTTTGCC|CGAGTCTGTTTTTTGCCCACCATATCACGT
GGAAAGGAAATCTGACATCGACAGAAATTC|GTTTTTTGCCCACTAGCGAGTCTGTTTTTT
CTGGATCCACTTTTCGGGTCCTAGCGAGTC|GGTCCTAGCGAGTCTGTTTTTTGCCCACTG
CCCACTAGCGAGTCTGTTTTTTGCCCACAC|ATCGATTCCGCTACGGGGTCGTATGCACAG
CCATAGCGTATTCAAGTGAAATCTGAGTAC|GTCCGTTGGCTCGGGTCCTAGCGAGTCTGT
CACTTGTATGGTCTCATTTATATTCGGGTC|GGAAATCTGACATCGACAGAAATTCTTGCG
GTTGCCGGGTCCTAGCGAGTCTGTTTTTTG|TTTGCCCACCCCAAAACCTCACACGGCAGG
GCCTGACGTTCATCTACAACGGGTCCTAGC|TCTCCGTTGCTATTACCGCATAATTTTCAA
GGGTCCTAGCGAGTCTGTTTTTTGCCCACT|TGTTTTTTGCCCACCCACGGCGCCGGGTCC
GCGAGTCTGTTTTTTGCCCACGTATCCCAA|AACCTCACACGGCAGGAACGGCGCCAGCGA
CCACTACTTATAAGCGCCTTCGTCGGCTGG|TCTGTTTTTTGCCCACGGGTCCTAGCGAGT
ACGATAACAACTACTAGCCGTATGCCCTAG|CGGGTCCTAGCGAGTCTGTTTTTTGCCCAC
CGAGTCTGTTTTTTGCCCACCCCAAAACCT|ACAAAGCGCACGTCCACTACCTGCTAATAC
TCAACAAAGCGCACGTCCACTACCTGCTAA|GTCCTAGCGAGTCTGTTTTTTGCCCACGTA
TATCATTCACGATGCAAAAGGCTTGCTCCG|ACATTATGTGCGTGCTCTTAGTCCTCTCCA
GTGCGCTTAGGCGGTATGATATCTAGGAGC|ACTGGTTAGTTGTCGGTAGAACATGCTGAT
GCGTGCTCTTAGTCCTCTCCAGATGTGACG|CTCCAAACTACGTCCTACTAGTACTTGCCT
CGATGCTGAATGGGTTAGGGAAAGGAAATC|CCGGGTCCTAGCGAGTCTGTTTTTTGCCCA
CTATCATTCACGATGCAAAAGGCTTGCTCC|GACATTATGTGCGTGCTCTTAGTCCTCTCC
TGCCCACCCCAAAACCTCACACGGCAGGAA|CCACTACCTGCTAATACCAGTTTCCTCTGA
GGGTCGTATGCACAGACATTATGTGCGTGC|ACGCGAAATAACTGTATATGTCTTCTCCAA
GCCCACCCACGGCGCCGGGTCCTAGCGAGT|CGTTTGGTCAAACGGGCATTACGATAACAA
CCACTTTTCGGGTCCTAGCGAGTCTGTTTT|AGCGAGTCTGTTTTTTGCCCACTGTTTTTT
CCTAGCGAGTCTGTTTTTTGCCCACCATAT|TTTGCCCACTGTTTTTTGCCCACATGCGGC
TACTTTCCGGGTCCTAGCGAGTCTGCGGGT|TGTTTTTTGCCGGGTCCTAGCGAGTCTGTT
CTGAATGGGTTAGGGAAAGGAAATCTGACA|TCCTAGCGAGTCTGTTTTTTGCCCACTAGC
TTCAAGTGAAATCTGAGTACTTTCCGGGTC|TCGGGTCCTAGCGAGTCTGTTTTTTGCCGG
TAGCGAGTCTGTTTTTTGCCCACCTCGCCT|CGTAATGCTAATACAAGATGTAGCTCTCTC
TTTTTTGCCCACCCACGGCGCCGGGTCCTA|ATATCACGTTTGGTCAAACGGGCATTACGA
GTTTTTTGCCCACCATATCACGTTTGGTCA|TTTTTGCCCACATGCGGCATTGATCATTCG
CACTTTTTTGCCCACTACTTATAAGCGCCT|GTCCTAGCGAGTCTGTTTTTTGCCCACGGG
GCTACGGGGTCGTATGCACAGACATTATGT|AGTTTGACGCGAAATAACTGTATATGTCTT
GGCCACTCTACATGAACCGCGTCAGCTGAT|AAGAACAATATGCTAAGTAAGTTTGCCCAT
ATAACAACTACTAGCCGTATGCCCTAGACA|GTCCTAGCGAGTCTGTTTTTTGCCCACGTA
AACTGCACTTGTATGGTCTCATTTATATTC|GGAAAGGAAATCTGACATCGACAGAAATTC
CTGTTAATCGTCCCGCTGCCCCGCGTCCGG|TTCGGATACAGGATGTGCGCTTAGGCGGTA
GCGCACGTCCACTACCTGCTAATACCAGTT|GAGTCTGTTTTTTGCCCACGTACCTGTTAA
TTTTTGCCCACACTATCATTCACGATGCAA|GTCGTATGCACAGACATTATGTGCGTGCTC
TACAAGAATAACTGCACTTGTATGGTCTCA|ATGGGTTAGGGAAAGGAAATCTGACATCGA
ATGCCCTAGACAGTGACTTTCGGGTCCTAG|TTTGCCCACGTATCCCAAAGGAGGAATATA
TTCCGGGTCCTAGCGAGTCTGCGGGTCCTA|TTTTGCCGGGTCCTAGCGAGTCTGTTTTTT
TTGCTATTACCGCATAATTTTCAACAAAGC|ATGGTCTCATTTATATTCGGGTCCTAGCGA
AACAAAGCGCACGTCCACTACCTGCTAATA|CCTAGCGAGTCTGTTTTTTGCCCACGTACC
TTGCCCACTTTTTTGCCCACTACTTATAAG|GCCGGGTCCTAGCGAGTCTGTTTTTTGCCC
CAAACGGGCATTACGATAACAACTACTAGC|CGCTCCCGTTGCCGGGTCCTAGCGAGTCTG
ATATAGCGGGTCCTAGCGAGTCTGTTTTTT|TGACGTTCCTAATCGTAATGCTAATACAAG
TATGCCCTAGACAGTGACTTTCGGGTCCTA|TTTTGCCCACGTATCCCAAAGGAGGAATAT
TTTTGCCCACACTATCATTCACGATGCAAA|TCGTATGCACAGACATTATGTGCGTGCTCT
TCGGGTCCTAGCGAGTCTGTTTTTTGCCGG|CTGGATCCACTTTTCGGGTCCTAGCGAGTC
ACCGTGAGACTGTATCCGAATCACGTTACA|CGAAGCACCGCGAGTCTCGATGCTGAATGG
CGAGTCTGTTTTTTGCCGGGTCCTAGCGAG|TTTCGGGTCCTAGCGAGTCTGTTTTTTGCC
CGGGTCCTAGCGAGTCTGTTTTTTGCCGGG|TGGATCCACTTTTCGGGTCCTAGCGAGTCT
GAACATGCTGATACTGGCCACTCTACATGA|CTGCACCGTGATATTAAGAACAATATGCTA
CCACGTACCTGTTAATCGTCCCGCTGCCCC|ACAGTTGCTTCGGATACAGGATGTGCGCTT
TAGCGAGTCTGTTTTTTGCCCACATGATCT|CAGTGACTTTCGGGTCCTAGCGAGTCCGGG
TGAACCGCGTCAGCTGATCGATTCCGCTAC|CTAAGTAAGTTTGCCCATAACCCTCAGTTT
ATATCACGTTTGGTCAAACGGGCATTACGA|CGGCATTGATCATTCGCTCCCGTTGCCGGG
CAGCGATCGGCAGTGACGTTCCTAATCGTA|ACCTCCCCTTGACCGTGAGACTGTATCCGA
CTGTTTTTTGCCCACCTCGCCTGACGTTCA|TAATACAAGATGTAGCTCTCTCCGTTGCTA
CCTAGCGAGTCCGGGTCCTAGCGAGTCTGT|ATATAGCGGGTCCTAGCGAGTCTGTTTTTT
TTTGCCCACCCCAAAACCTCACACGGCAGG|GTCCACTACCTGCTAATACCAGTTTCCTCT
TTTGCCCACATGCGGCATTGATCATTCGCT|GTTCATCTACAACGGGTCCTAGCGAGTCTG
TTCGGGTCCTAGCGAGTCTGTTTTTTGCCC|TCTGTTTTTTGCCCACTGTTTTTTGCCCAC
GACCTTCGCAGCAGGAAGCTCACAGTTGCT|ACACTATCATTCACGATGCAAAAGGCTTGC
TGTTTTTTGCCCACCTCGCCTGACGTTCAT|AATACAAGATGTAGCTCTCTCCGTTGCTAT
CCGGGTCCTAGCGAGTCTGCGGGTCCTAGC|TTGCCGGGTCCTAGCGAGTCTGTTTTTTGC
TGTTTTTTGCCCACTAGCGAGTCTGTTTTT|CGTCAGCTGATCGATTCCGCTACGGGGTCG
TAGCTCTCTCCGTTGCTATTACCGCATAAT|AACTGCACTTGTATGGTCTCATTTATATTC
GTATGATATCTAGGAGCGGGTCCCGGGTCC|CGGTAGAACATGCTGATACTGGCCACTCTA
TCGGCTGGGCCGTACCTTGTCCGTTGGCTC|TAGCGAGTCTGTTTTTTGCCCACATGATCT
TCGCAGCAGGAAGCTCACAGTTGCTTCGGA|ATCATTCACGATGCAAAAGGCTTGCTCCGG
AATTCTTGCGACCTTCGCAGCAGGAAGCTC|TTTTTGCCCACACTATCATTCACGATGCAA
ATCACGTTTGGTCAAACGGGCATTACGATA|GCATTGATCATTCGCTCCCGTTGCCGGGTC
TCGGGTCCTAGCGAGTCTGTTTTTTGCCCA|CTGTTTTTTGCCCACTGTTTTTTGCCCACA
GTTGCTTCGGATACAGGATGTGCGCTTAGG|GCTTGCTCCGGACGTACTGACTGGTTAGTT
ATATTCGGGTCCTAGCGAGTCTGTTTTTTG|AAATTCTTGCGACCTTCGCAGCAGGAAGCT
TTCGGGTCCTAGCGAGTCCGGGTCCTAGCG|AGGAGGAATATAGCGGGTCCTAGCGAGTCT
GTTGTCGGTAGAACATGCTGATACTGGCCA|CGATCAGCCGCTGCACCGTGATATTAAGAA
TTTCGGGTCCTAGCGAGTCCGGGTCCTAGC|AAGGAGGAATATAGCGGGTCCTAGCGAGTC
TTGGTCAAACGGGCATTACGATAACAACTA|TCATTCGCTCCCGTTGCCGGGTCCTAGCGA
TTAGTTGTCGGTAGAACATGCTGATACTGG|TCACGATCAGCCGCTGCACCGTGATATTAA
TCTCCAGATGTGACGATCCGTCACGATCAG|TACTAGTACTTGCCTTTCCCTAGGTCGATC
TTATAAGCGCCTTCGTCGGCTGGGCCGTAC|TTTGCCCACGGGTCCTAGCGAGTCTGTTTT
TCTTAGTCCTCTCCAGATGTGACGATCCGT|ACTACGTCCTACTAGTACTTGCCTTTCCCT
TTAATCGTCCCGCTGCCCCGCGTCCGGTGC|GGATACAGGATGTGCGCTTAGGCGGTATGA
AGTCTGTTTTTTGCCCACCCCAAAACCTCA|AAAGCGCACGTCCACTACCTGCTAATACCA
AGTCTGTTTTTTGCCCACTAGCGAGTCTGT|ACCGCGTCAGCTGATCGATTCCGCTACGGG
GGTCCTAGCGAGTCTGTTTTTTGCCCACCC|CTGTTTTTTGCCCACCATATCACGTTTGGT
ACCTTGTCCGTTGGCTCGGGTCCTAGCGAG|TTTTGCCCACATGATCTGGATCCACTTTTC
TCATCTACAACGGGTCCTAGCGAGTCTGTT|CTATTACCGCATAATTTTCAACAAAGCGCA
AGTCTGTTTTTTGCCCACGTATCCCAAAGG|CTCACACGGCAGGAACGGCGCCAGCGATCG
AAAACCTCACACGGCAGGAACGGCGCCAGC|CTAATACCAGTTTCCTCTGACTTTAAACCT
CGCCTGACGTTCATCTACAACGGGTCCTAG|CTCTCCGTTGCTATTACCGCATAATTTTCA
CCCATAGCGTATTCAAGTGAAATCTGAGTA|TGTCCGTTGGCTCGGGTCCTAGCGAGTCTG
GAATAACTGCACTTGTATGGTCTCATTTAT|TTAGGGAAAGGAAATCTGACATCGACAGAA
GTGAAATCTGAGTACTTTCCGGGTCCTAGC|TCCTAGCGAGTCTGTTTTTTGCCGGGTCCT
CCACATGATCTGGATCCACTTTTCGGGTCC|GCGAGTCCGGGTCCTAGCGAGTCTGTTTTT
TGGCCACTCTACATGAACCGCGTCAGCTGA|TAAGAACAATATGCTAAGTAAGTTTGCCCA
CGTATTCAAGTGAAATCTGAGTACTTTCCG|TGGCTCGGGTCCTAGCGAGTCTGTTTTTTG
CCGGTGCGAAGCACCGCGAGTCTCGATGCT|GGTATGATATCTAGGAGCGGGTCCCGGGTC
GGAATATAGCGGGTCCTAGCGAGTCTGTTT|CAGTGACGTTCCTAATCGTAATGCTAATAC
ACATGATCTGGATCCACTTTTCGGGTCCTA|GAGTCCGGGTCCTAGCGAGTCTGTTTTTTG
GGTCCTAGCGAGTCCGGGTCCTAGCGAGTC|GGAATATAGCGGGTCCTAGCGAGTCTGTTT
TAGCGAGTCTGTTTTTTGCCCACCCACGGC|TTTTGCCCACCATATCACGTTTGGTCAAAC
GCCGGGTCCTAGCGAGTCTGTTTTTTGCCC|GCCCACCCCAAAACCTCACACGGCAGGAAC
TGCAAAAGGCTTGCTCCGGACGTACTGACT|TGCTCTTAGTCCTCTCCAGATGTGACGATC
ATCCCAAAGGAGGAATATAGCGGGTCCTAG|CCAGCGATCGGCAGTGACGTTCCTAATCGT
TCACGATGCAAAAGGCTTGCTCCGGACGTA|TGTGCGTGCTCTTAGTCCTCTCCAGATGTG
GGGTTAGGGAAAGGAAATCTGACATCGACA|CGAGTCTGTTTTTTGCCCACTAGCGAGTCT
ATAATTTTCAACAAAGCGCACGTCCACTAC|TATTCGGGTCCTAGCGAGTCTGTTTTTTGC
AGCGAGTCTGTTTTTTGCCCACCATATCAC|GCCCACTGTTTTTTGCCCACATGCGGCATT
CTTTAAACCTCCCCTTGACCGTGAGACTGT|CTGCCCCGCGTCCGGTGCGAAGCACCGCGA
ATAGCGTATTCAAGTGAAATCTGAGTACTT|CCGTTGGCTCGGGTCCTAGCGAGTCTGTTT
TCCTCTCCAGATGTGACGATCCGTCACGAT|TCCTACTAGTACTTGCCTTTCCCTAGGTCG
TGTTTTTTGCCCACCCCAAAACCTCACACG|CGCACGTCCACTACCTGCTAATACCAGTTT
CCACGTATCCCAAAGGAGGAATATAGCGGG|ACGGCGCCAGCGATCGGCAGTGACGTTCCT
GGTCAAACGGGCATTACGATAACAACTACT|ATTCGCTCCCGTTGCCGGGTCCTAGCGAGT
ATGATATCTAGGAGCGGGTCCCGGGTCCTA|GTAGAACATGCTGATACTGGCCACTCTACA
TGAGACTGTATCCGAATCACGTTACAAGAA|GCACCGCGAGTCTCGATGCTGAATGGGTTA
CCCGTTGCCGGGTCCTAGCGAGTCTGTTTT|TTTTTTGCCCACCCCAAAACCTCACACGGC
TGCGAAGCACCGCGAGTCTCGATGCTGAAT|TGATATCTAGGAGCGGGTCCCGGGTCCTAG
GTCAAACGGGCATTACGATAACAACTACTA|TTCGCTCCCGTTGCCGGGTCCTAGCGAGTC
AGGAAGCTCACAGTTGCTTCGGATACAGGA|ACGATGCAAAAGGCTTGCTCCGGACGTACT
TTTTTTGCCCACTAGCGAGTCTGTTTTTTG|TCAGCTGATCGATTCCGCTACGGGGTCGTA
TTGTCGGTAGAACATGCTGATACTGGCCAC|GATCAGCCGCTGCACCGTGATATTAAGAAC
GCGGGTCCTAGCGAGTCTGTTTTTTGCCCA|TCTGTTTTTTGCCCACCCACGGCGCCGGGT
GTGACGATCCGTCACGATCAGCCGCTGCAC|TTGCCTTTCCCTAGGTCGATCGAGAATCTG
TTGCCCACTAGCGAGTCTGTTTTTTGCCCA|CTGATCGATTCCGCTACGGGGTCGTATGCA
TTGCCCACGTATCCCAAAGGAGGAATATAG|AGGAACGGCGCCAGCGATCGGCAGTGACGT
CTAGCGAGTCTGTTTTTTGCCCACTGTTTT|GAGTCTGTTTTTTGCCCACCTCGCCTGACG
AGCGAGTCCGGGTCCTAGCGAGTCTGTTTT|TAGCGGGTCCTAGCGAGTCTGTTTTTTGCC
GTCCCGCTGCCCCGCGTCCGGTGCGAAGCA|AGGATGTGCGCTTAGGCGGTATGATATCTA
ATGCGGCATTGATCATTCGCTCCCGTTGCC|CAACGGGTCCTAGCGAGTCTGTTTTTTGCC
CCGCTGCCCCGCGTCCGGTGCGAAGCACCG|ATGTGCGCTTAGGCGGTATGATATCTAGGA
CGAGTCTGTTTTTTGCCCACCATATCACGT|CCACTGTTTTTTGCCCACATGCGGCATTGA
GTACCTTGTCCGTTGGCTCGGGTCCTAGCG|TTTTTTGCCCACATGATCTGGATCCACTTT
CCCACGTATCCCAAAGGAGGAATATAGCGG|AACGGCGCCAGCGATCGGCAGTGACGTTCC
GGGTCCTAGCGAGTCTGCGGGTCCTAGCGA|GCCGGGTCCTAGCGAGTCTGTTTTTTGCCC
GTTAGTTGTCGGTAGAACATGCTGATACTG|GTCACGATCAGCCGCTGCACCGTGATATTA
CCTGTTAATCGTCCCGCTGCCCCGCGTCCG|CTTCGGATACAGGATGTGCGCTTAGGCGGT
TTACAAGAATAACTGCACTTGTATGGTCTC|AATGGGTTAGGGAAAGGAAATCTGACATCG
TCCAGATGTGACGATCCGTCACGATCAGCC|CTAGTACTTGCCTTTCCCTAGGTCGATCGA
GTCACGATCAGCCGCTGCACCGTGATATTA|CTAGGTCGATCGAGAATCTGAGTCACTCAA
CGTAATGCTAATACAAGATGTAGCTCTCTC|CCGAATCACGTTACAAGAATAACTGCACTT
CCCAAAGGAGGAATATAGCGGGTCCTAGCG|AGCGATCGGCAGTGACGTTCCTAATCGTAA
CCACATGCGGCATTGATCATTCGCTCCCGT|TCTACAACGGGTCCTAGCGAGTCTGTTTTT
TCGTCGGCTGGGCCGTACCTTGTCCGTTGG|TCCTAGCGAGTCTGTTTTTTGCCCACATGA
TTACGATAACAACTACTAGCCGTATGCCCT|GCCGGGTCCTAGCGAGTCTGTTTTTTGCCC
CTTTTTTGCCCACTACTTATAAGCGCCTTC|CCTAGCGAGTCTGTTTTTTGCCCACGGGTC
CCTCTGACTTTAAACCTCCCCTTGACCGTG|CGTCCCGCTGCCCCGCGTCCGGTGCGAAGC
AGCGAGTCTGTTTTTTGCCCACTTTTTTGC|TGCCCACCCACGGCGCCGGGTCCTAGCGAG
GGTCCTAGCGAGTCTGTTTTTTGCCCACGT|ACCCCAAAACCTCACACGGCAGGAACGGCG
AAGAATAACTGCACTTGTATGGTCTCATTT|GGTTAGGGAAAGGAAATCTGACATCGACAG
CATTCACGATGCAAAAGGCTTGCTCCGGAC|TTATGTGCGTGCTCTTAGTCCTCTCCAGAT
CAGGAAGCTCACAGTTGCTTCGGATACAGG|CACGATGCAAAAGGCTTGCTCCGGACGTAC
TAGCGAGTCTGTTTTTTGCCCACTGTTTTT|AGTCTGTTTTTTGCCCACCTCGCCTGACGT
ATCTGACATCGACAGAAATTCTTGCGACCT|CCACTAGCGAGTCTGTTTTTTGCCCACACT
GACGTACTGACTGGTTAGTTGTCGGTAGAA|GATGTGACGATCCGTCACGATCAGCCGCTG
CGGGGTCGTATGCACAGACATTATGTGCGT|TGACGCGAAATAACTGTATATGTCTTCTCC
CCCACTTTTTTGCCCACTACTTATAAGCGC|GGGTCCTAGCGAGTCTGTTTTTTGCCCACG
GACTGTATCCGAATCACGTTACAAGAATAA|CCGCGAGTCTCGATGCTGAATGGGTTAGGG
AGGATGTGCGCTTAGGCGGTATGATATCTA|TACTGACTGGTTAGTTGTCGGTAGAACATG
GAACGGCGCCAGCGATCGGCAGTGACGTTC|TGACTTTAAACCTCCCCTTGACCGTGAGAC
TCTTGCGACCTTCGCAGCAGGAAGCTCACA|TTGCCCACACTATCATTCACGATGCAAAAG
GACCGTGAGACTGTATCCGAATCACGTTAC|GCGAAGCACCGCGAGTCTCGATGCTGAATG
GCGACCTTCGCAGCAGGAAGCTCACAGTTG|CCACACTATCATTCACGATGCAAAAGGCTT
TAGCGAGTCTGTTTTTTGCCCACCCCAAAA|TCAACAAAGCGCACGTCCACTACCTGCTAA
GCGCCTTCGTCGGCTGGGCCGTACCTTGTC|CACGGGTCCTAGCGAGTCTGTTTTTTGCCC
AGTACTTTCCGGGTCCTAGCGAGTCTGCGG|TCTGTTTTTTGCCGGGTCCTAGCGAGTCTG
ACAGTTGCTTCGGATACAGGATGTGCGCTT|AAGGCTTGCTCCGGACGTACTGACTGGTTA
GCATGACCCATAGCGTATTCAAGTGAAATC|GTACCTTGTCCGTTGGCTCGGGTCCTAGCG
AATACCAGTTTCCTCTGACTTTAAACCTCC|TACCTGTTAATCGTCCCGCTGCCCCGCGTC
GTAGAACATGCTGATACTGGCCACTCTACA|CCGCTGCACCGTGATATTAAGAACAATATG
ACTTTCCGGGTCCTAGCGAGTCTGCGGGTC|GTTTTTTGCCGGGTCCTAGCGAGTCTGTTT
TTTTTGCCCACATGCGGCATTGATCATTCG|ACGTTCATCTACAACGGGTCCTAGCGAGTC
TGACTTTCGGGTCCTAGCGAGTCCGGGTCC|CCCAAAGGAGGAATATAGCGGGTCCTAGCG
TAACAACTACTAGCCGTATGCCCTAGACAG|TCCTAGCGAGTCTGTTTTTTGCCCACGTAT
CTAGCGAGTCTGTTTTTTGCCCACGGGTCC|CGATAACAACTACTAGCCGTATGCCCTAGA
TTGCCCACCCACGGCGCCGGGTCCTAGCGA|CACGTTTGGTCAAACGGGCATTACGATAAC
CCTAGCGAGTCTGTTTTTTGCCCACCCACG|TTTTTTGCCCACCATATCACGTTTGGTCAA
CCACTACCTGCTAATACCAGTTTCCTCTGA|TTTTTGCCCACGTACCTGTTAATCGTCCCG
CGGGTCCTAGCGAGTCTGTTTTTTGCCCAC|TGTTTTTTGCCCACTGTTTTTTGCCCACAT
TTGCCCACCTCGCCTGACGTTCATCTACAA|AGATGTAGCTCTCTCCGTTGCTATTACCGC
ACCTCCCCTTGACCGTGAGACTGTATCCGA|CGCGTCCGGTGCGAAGCACCGCGAGTCTCG
CTCTCTCCGTTGCTATTACCGCATAATTTT|TGCACTTGTATGGTCTCATTTATATTCGGG
CTTGACCGTGAGACTGTATCCGAATCACGT|GGTGCGAAGCACCGCGAGTCTCGATGCTGA
CACGGCGCCGGGTCCTAGCGAGTCTGTTTT|TCAAACGGGCATTACGATAACAACTACTAG
CTAGGAGCGGGTCCCGGGTCCTAGCGAGTC|ATGCTGATACTGGCCACTCTACATGAACCG
CGGTGCGAAGCACCGCGAGTCTCGATGCTG|GTATGATATCTAGGAGCGGGTCCCGGGTCC
TGACGTTCATCTACAACGGGTCCTAGCGAG|CCGTTGCTATTACCGCATAATTTTCAACAA
CTGCTAATACCAGTTTCCTCTGACTTTAAA|CCACGTACCTGTTAATCGTCCCGCTGCCCC
ACTGGTTAGTTGTCGGTAGAACATGCTGAT|ATCCGTCACGATCAGCCGCTGCACCGTGAT
TGCCCACTTTTTTGCCCACTACTTATAAGC|CCGGGTCCTAGCGAGTCTGTTTTTTGCCCA
TTTTTTGCCCACCATATCACGTTTGGTCAA|TTTTGCCCACATGCGGCATTGATCATTCGC
GTCCGGTGCGAAGCACCGCGAGTCTCGATG|GCGGTATGATATCTAGGAGCGGGTCCCGGG
TTCCTAATCGTAATGCTAATACAAGATGTA|GACTGTATCCGAATCACGTTACAAGAATAA
CGAGTCTGTTTTTTGCCCACGTACCTGTTA|TCGCAGCAGGAAGCTCACAGTTGCTTCGGA
TCGCTCCCGTTGCCGGGTCCTAGCGAGTCT|GTCTGTTTTTTGCCCACCCCAAAACCTCAC
ACAGGATGTGCGCTTAGGCGGTATGATATC|CGTACTGACTGGTTAGTTGTCGGTAGAACA
TCTGACATCGACAGAAATTCTTGCGACCTT|CACTAGCGAGTCTGTTTTTTGCCCACACTA
TGTGCGTGCTCTTAGTCCTCTCCAGATGTG|CTTCTCCAAACTACGTCCTACTAGTACTTG
AGTCCGGGTCCTAGCGAGTCTGTTTTTTGC|GGGTCCTAGCGAGTCTGTTTTTTGCCCACC
GCCCACCATATCACGTTTGGTCAAACGGGC|CCACATGCGGCATTGATCATTCGCTCCCGT
CCTAGCGAGTCTGTTTTTTGCCCACCCCAA|TTTCAACAAAGCGCACGTCCACTACCTGCT
GGCATTACGATAACAACTACTAGCCGTATG|CGTTGCCGGGTCCTAGCGAGTCTGTTTTTT
CTACATGAACCGCGTCAGCTGATCGATTCC|ATATGCTAAGTAAGTTTGCCCATAACCCTC
TGATACTGGCCACTCTACATGAACCGCGTC|TGATATTAAGAACAATATGCTAAGTAAGTT
GGCTTGCTCCGGACGTACTGACTGGTTAGT|AGTCCTCTCCAGATGTGACGATCCGTCACG
GTATCCGAATCACGTTACAAGAATAACTGC|GAGTCTCGATGCTGAATGGGTTAGGGAAAG
GGTCCTAGCGAGTCTGTTTTTTGCCCACGT|TGCGACCTTCGCAGCAGGAAGCTCACAGTT
CACTGTTTTTTGCCCACATGCGGCATTGAT|CGCCTGACGTTCATCTACAACGGGTCCTAG
CGGACGTACTGACTGGTTAGTTGTCGGTAG|CAGATGTGACGATCCGTCACGATCAGCCGC
AGCGAGTCTGTTTTTTGCCCACTGTTTTTT|GTCTGTTTTTTGCCCACCTCGCCTGACGTT
GTTTTTTGCCCACTAGCGAGTCTGTTTTTT|GTCAGCTGATCGATTCCGCTACGGGGTCGT
GGAGCGGGTCCCGGGTCCTAGCGAGTCTGT|CTGATACTGGCCACTCTACATGAACCGCGT
TCCTAGCGAGTCTGTTTTTTGCCCACCATA|TTTTGCCCACTGTTTTTTGCCCACATGCGG
TCCGGACGTACTGACTGGTTAGTTGTCGGT|TCCAGATGTGACGATCCGTCACGATCAGCC
GCGATCGGCAGTGACGTTCCTAATCGTAAT|CTCCCCTTGACCGTGAGACTGTATCCGAAT
GCGGCATTGATCATTCGCTCCCGTTGCCGG|ACGGGTCCTAGCGAGTCTGTTTTTTGCCCA
CTAGCGAGTCTGTTTTTTGCCCACCATATC|TTGCCCACTGTTTTTTGCCCACATGCGGCA
GTCCTAGCGAGTCTGTTTTTTGCCCACGGG|TTACGATAACAACTACTAGCCGTATGCCCT
ATGCTAATACAAGATGTAGCTCTCTCCGTT|ATCACGTTACAAGAATAACTGCACTTGTAT
TGTTTTTTGCCGGGTCCTAGCGAGTCTGTT|GTCCTAGCGAGTCTGTTTTTTGCCCACCAT
CAGATGTGACGATCCGTCACGATCAGCCGC|AGTACTTGCCTTTCCCTAGGTCGATCGAGA
CCACTCTACATGAACCGCGTCAGCTGATCG|GAACAATATGCTAAGTAAGTTTGCCCATAA
ACGGGCATTACGATAACAACTACTAGCCGT|TCCCGTTGCCGGGTCCTAGCGAGTCTGTTT
AACCTCACACGGCAGGAACGGCGCCAGCGA|AATACCAGTTTCCTCTGACTTTAAACCTCC
AAACCTCACACGGCAGGAACGGCGCCAGCG|TAATACCAGTTTCCTCTGACTTTAAACCTC
AGAAATTCTTGCGACCTTCGCAGCAGGAAG|TGTTTTTTGCCCACACTATCATTCACGATG
TTTTGCCCACTACTTATAAGCGCCTTCGTC|AGCGAGTCTGTTTTTTGCCCACGGGTCCTA
GCTCTCTCCGTTGCTATTACCGCATAATTT|CTGCACTTGTATGGTCTCATTTATATTCGG
ACTCTACATGAACCGCGTCAGCTGATCGAT|ACAATATGCTAAGTAAGTTTGCCCATAACC
TATAAGCGCCTTCGTCGGCTGGGCCGTACC|TTGCCCACGGGTCCTAGCGAGTCTGTTTTT
GCACAGACATTATGTGCGTGCTCTTAGTCC|AACTGTATATGTCTTCTCCAAACTACGTCC
GAGGAATATAGCGGGTCCTAGCGAGTCTGT|GGCAGTGACGTTCCTAATCGTAATGCTAAT
TTGCTCCGGACGTACTGACTGGTTAGTTGT|CCTCTCCAGATGTGACGATCCGTCACGATC
ATACAAGATGTAGCTCTCTCCGTTGCTATT|TTACAAGAATAACTGCACTTGTATGGTCTC
ACAGAAATTCTTGCGACCTTCGCAGCAGGA|TCTGTTTTTTGCCCACACTATCATTCACGA
TAGTCCTCTCCAGATGTGACGATCCGTCAC|ACGTCCTACTAGTACTTGCCTTTCCCTAGG
GCCCTAGACAGTGACTTTCGGGTCCTAGCG|TGCCCACGTATCCCAAAGGAGGAATATAGC
AATCGTCCCGCTGCCCCGCGTCCGGTGCGA|ATACAGGATGTGCGCTTAGGCGGTATGATA
TCTGTTTTTTGCCCACTTTTTTGCCCACTA|CCCACGGCGCCGGGTCCTAGCGAGTCTGTT
ACAACTACTAGCCGTATGCCCTAGACAGTG|CTAGCGAGTCTGTTTTTTGCCCACGTATCC
TCAAACGGGCATTACGATAACAACTACTAG|TCGCTCCCGTTGCCGGGTCCTAGCGAGTCT
AGCTGATCGATTCCGCTACGGGGTCGTATG|TGCCCATAACCCTCAGTTTGACGCGAAATA
GAGTCTGTTTTTTGCCCACCTCGCCTGACG|ATGCTAATACAAGATGTAGCTCTCTCCGTT
AGTGAAATCTGAGTACTTTCCGGGTCCTAG|GTCCTAGCGAGTCTGTTTTTTGCCGGGTCC
GACTTTCGGGTCCTAGCGAGTCCGGGTCCT|CCAAAGGAGGAATATAGCGGGTCCTAGCGA
CCGTATGCCCTAGACAGTGACTTTCGGGTC|GTTTTTTGCCCACGTATCCCAAAGGAGGAA
ACTTATAAGCGCCTTCGTCGGCTGGGCCGT|TTTTTGCCCACGGGTCCTAGCGAGTCTGTT
GGTCCTAGCGAGTCTGTTTTTTGCCCACCA|TTTTTTGCCCACTGTTTTTTGCCCACATGC
GGTTAGGGAAAGGAAATCTGACATCGACAG|GAGTCTGTTTTTTGCCCACTAGCGAGTCTG
CGAGTCTGTTTTTTGCCCACCCACGGCGCC|TGCCCACCATATCACGTTTGGTCAAACGGG
CCGGGTCCTAGCGAGTCTGTTTTTTGCCCA|CCCACCCCAAAACCTCACACGGCAGGAACG
TGAGTACTTTCCGGGTCCTAGCGAGTCTGC|AGTCTGTTTTTTGCCGGGTCCTAGCGAGTC
GGGTCCTAGCGAGTCTGTTTTTTGCCCACG|CACCCCAAAACCTCACACGGCAGGAACGGC
GCATTACGATAACAACTACTAGCCGTATGC|GTTGCCGGGTCCTAGCGAGTCTGTTTTTTG
CCGCGAGTCTCGATGCTGAATGGGTTAGGG|GGAGCGGGTCCCGGGTCCTAGCGAGTCTGT
GGGTCCTAGCGAGTCTGTTTTTTGCCCACC|GTTTTTTGCCCACTGTTTTTTGCCCACATG
AGCGAGTCTGTTTTTTGCCCACATGATCTG|AGTGACTTTCGGGTCCTAGCGAGTCCGGGT
AAGGAGGAATATAGCGGGTCCTAGCGAGTC|ATCGGCAGTGACGTTCCTAATCGTAATGCT
TATGCACAGACATTATGTGCGTGCTCTTAG|AATAACTGTATATGTCTTCTCCAAACTACG
ATTGATCATTCGCTCCCGTTGCCGGGTCCT|TCCTAGCGAGTCTGTTTTTTGCCCACCCCA
TATGGTCTCATTTATATTCGGGTCCTAGCG|CTGACATCGACAGAAATTCTTGCGACCTTC
GATGCTGAATGGGTTAGGGAAAGGAAATCT|CGGGTCCTAGCGAGTCTGTTTTTTGCCCAC
GTGACTTTCGGGTCCTAGCGAGTCCGGGTC|TCCCAAAGGAGGAATATAGCGGGTCCTAGC
CACTACTTATAAGCGCCTTCGTCGGCTGGG|CTGTTTTTTGCCCACGGGTCCTAGCGAGTC
TAGCGTATTCAAGTGAAATCTGAGTACTTT|CGTTGGCTCGGGTCCTAGCGAGTCTGTTTT
CTGAGTACTTTCCGGGTCCTAGCGAGTCTG|GAGTCTGTTTTTTGCCGGGTCCTAGCGAGT
CTAGCGAGTCTGTTTTTTGCCCACGTATCC|CAAAACCTCACACGGCAGGAACGGCGCCAG
AGCGAGTCTGTTTTTTGCCCACGTATCCCA|AAACCTCACACGGCAGGAACGGCGCCAGCG
AGCCGTATGCCCTAGACAGTGACTTTCGGG|CTGTTTTTTGCCCACGTATCCCAAAGGAGG
GATCGGCAGTGACGTTCCTAATCGTAATGC|CCCCTTGACCGTGAGACTGTATCCGAATCA
TCCTAGCGAGTCTGTTTTTTGCCCACCCAC|GTTTTTTGCCCACCATATCACGTTTGGTCA
GACTTTAAACCTCCCCTTGACCGTGAGACT|CGCTGCCCCGCGTCCGGTGCGAAGCACCGC
TGCTGATACTGGCCACTCTACATGAACCGC|CCGTGATATTAAGAACAATATGCTAAGTAA
GGAGGAATATAGCGGGTCCTAGCGAGTCTG|CGGCAGTGACGTTCCTAATCGTAATGCTAA
CTGACTGGTTAGTTGTCGGTAGAACATGCT|ACGATCCGTCACGATCAGCCGCTGCACCGT
CTAATACAAGATGTAGCTCTCTCCGTTGCT|ACGTTACAAGAATAACTGCACTTGTATGGT
AGATGTGACGATCCGTCACGATCAGCCGCT|GTACTTGCCTTTCCCTAGGTCGATCGAGAA
ACTTGTATGGTCTCATTTATATTCGGGTCC|GAAATCTGACATCGACAGAAATTCTTGCGA
GGCTCGGGTCCTAGCGAGTCTGTTTTTTGC|GATCTGGATCCACTTTTCGGGTCCTAGCGA
ACGGCGCCGGGTCCTAGCGAGTCTGTTTTT|CAAACGGGCATTACGATAACAACTACTAGC
CCAGTTTCCTCTGACTTTAAACCTCCCCTT|TGTTAATCGTCCCGCTGCCCCGCGTCCGGT
CTGTTTTTTGCCCACCATATCACGTTTGGT|GTTTTTTGCCCACATGCGGCATTGATCATT
CTGTTTTTTGCCCACGTATCCCAAAGGAGG|ACACGGCAGGAACGGCGCCAGCGATCGGCA
TATTACCGCATAATTTTCAACAAAGCGCAC|TCTCATTTATATTCGGGTCCTAGCGAGTCT
TGAATGGGTTAGGGAAAGGAAATCTGACAT|CCTAGCGAGTCTGTTTTTTGCCCACTAGCG
GTCGGCTGGGCCGTACCTTGTCCGTTGGCT|CTAGCGAGTCTGTTTTTTGCCCACATGATC
CCCACATGCGGCATTGATCATTCGCTCCCG|ATCTACAACGGGTCCTAGCGAGTCTGTTTT
TATTCAAGTGAAATCTGAGTACTTTCCGGG|GCTCGGGTCCTAGCGAGTCTGTTTTTTGCC
TTGCCGGGTCCTAGCGAGTCTGTTTTTTGC|GCGAGTCTGTTTTTTGCCCACCATATCACG
ACTGACTGGTTAGTTGTCGGTAGAACATGC|GACGATCCGTCACGATCAGCCGCTGCACCG
CGTTGCTATTACCGCATAATTTTCAACAAA|GTATGGTCTCATTTATATTCGGGTCCTAGC
TTCACGATGCAAAAGGCTTGCTCCGGACGT|ATGTGCGTGCTCTTAGTCCTCTCCAGATGT
GGGTCCTAGCGAGTCTGTTTTTTGCCCACG|TTGCGACCTTCGCAGCAGGAAGCTCACAGT
TTCGTCGGCTGGGCCGTACCTTGTCCGTTG|GTCCTAGCGAGTCTGTTTTTTGCCCACATG
AGATGTAGCTCTCTCCGTTGCTATTACCGC|AGAATAACTGCACTTGTATGGTCTCATTTA
CCCGCGTCCGGTGCGAAGCACCGCGAGTCT|CTTAGGCGGTATGATATCTAGGAGCGGGTC
TAGCGAGTCTGTTTTTTGCCCACACTATCA|TTCCGCTACGGGGTCGTATGCACAGACATT
CGTATGCACAGACATTATGTGCGTGCTCTT|GAAATAACTGTATATGTCTTCTCCAAACTA
AGGAGGAATATAGCGGGTCCTAGCGAGTCT|TCGGCAGTGACGTTCCTAATCGTAATGCTA
ACAGACATTATGTGCGTGCTCTTAGTCCTC|CTGTATATGTCTTCTCCAAACTACGTCCTA
GCGAGTCTGTTTTTTGCCCACTGTTTTTTG|TCTGTTTTTTGCCCACCTCGCCTGACGTTC
TCCCCTTGACCGTGAGACTGTATCCGAATC|GTCCGGTGCGAAGCACCGCGAGTCTCGATG
ATCTGGATCCACTTTTCGGGTCCTAGCGAG|CGGGTCCTAGCGAGTCTGTTTTTTGCCCAC
TATATTCGGGTCCTAGCGAGTCTGTTTTTT|GAAATTCTTGCGACCTTCGCAGCAGGAAGC
ACAGTGACTTTCGGGTCCTAGCGAGTCCGG|GTATCCCAAAGGAGGAATATAGCGGGTCCT
ACAAGATGTAGCTCTCTCCGTTGCTATTAC|ACAAGAATAACTGCACTTGTATGGTCTCAT
AGTCTGTTTTTTGCCCACCTCGCCTGACGT|TGCTAATACAAGATGTAGCTCTCTCCGTTG
CACCTCGCCTGACGTTCATCTACAACGGGT|TAGCTCTCTCCGTTGCTATTACCGCATAAT
CGGCATTGATCATTCGCTCCCGTTGCCGGG|CGGGTCCTAGCGAGTCTGTTTTTTGCCCAC
GCTGAATGGGTTAGGGAAAGGAAATCTGAC|GTCCTAGCGAGTCTGTTTTTTGCCCACTAG
TAAACCTCCCCTTGACCGTGAGACTGTATC|CCCCGCGTCCGGTGCGAAGCACCGCGAGTC
ATGTGACGATCCGTCACGATCAGCCGCTGC|ACTTGCCTTTCCCTAGGTCGATCGAGAATC
GAGTACTTTCCGGGTCCTAGCGAGTCTGCG|GTCTGTTTTTTGCCGGGTCCTAGCGAGTCT
CATATCACGTTTGGTCAAACGGGCATTACG|GCGGCATTGATCATTCGCTCCCGTTGCCGG
CAAGAATAACTGCACTTGTATGGTCTCATT|GGGTTAGGGAAAGGAAATCTGACATCGACA
GAGTCTCGATGCTGAATGGGTTAGGGAAAG|CGGGTCCCGGGTCCTAGCGAGTCTGTTTTT
CGTCCCGCTGCCCCGCGTCCGGTGCGAAGC|CAGGATGTGCGCTTAGGCGGTATGATATCT
CTACAACGGGTCCTAGCGAGTCTGTTTTTT|TACCGCATAATTTTCAACAAAGCGCACGTC
AAGCGCCTTCGTCGGCTGGGCCGTACCTTG|CCCACGGGTCCTAGCGAGTCTGTTTTTTGC
ACCTCGCCTGACGTTCATCTACAACGGGTC|AGCTCTCTCCGTTGCTATTACCGCATAATT
ACTGTTTTTTGCCCACATGCGGCATTGATC|GCCTGACGTTCATCTACAACGGGTCCTAGC
CTTATAAGCGCCTTCGTCGGCTGGGCCGTA|TTTTGCCCACGGGTCCTAGCGAGTCTGTTT
CTTGTCCGTTGGCTCGGGTCCTAGCGAGTC|TTGCCCACATGATCTGGATCCACTTTTCGG
TCCTAGCGAGTCTGTTTTTTGCCCACCTCG|AATCGTAATGCTAATACAAGATGTAGCTCT
GAGTCTGTTTTTTGCCCACGTATCCCAAAG|CCTCACACGGCAGGAACGGCGCCAGCGATC
AAAGGAGGAATATAGCGGGTCCTAGCGAGT|GATCGGCAGTGACGTTCCTAATCGTAATGC
CCAGATGTGACGATCCGTCACGATCAGCCG|TAGTACTTGCCTTTCCCTAGGTCGATCGAG
TGATCATTCGCTCCCGTTGCCGGGTCCTAG|CTAGCGAGTCTGTTTTTTGCCCACCCCAAA
CGAGTCCGGGTCCTAGCGAGTCTGTTTTTT|GCGGGTCCTAGCGAGTCTGTTTTTTGCCCA
CTAGCGAGTCTGTTTTTTGCCCACCTCGCC|TCGTAATGCTAATACAAGATGTAGCTCTCT
CGCTGCCCCGCGTCCGGTGCGAAGCACCGC|TGTGCGCTTAGGCGGTATGATATCTAGGAG
TATTCGGGTCCTAGCGAGTCTGTTTTTTGC|AATTCTTGCGACCTTCGCAGCAGGAAGCTC
ACTGGCCACTCTACATGAACCGCGTCAGCT|ATTAAGAACAATATGCTAAGTAAGTTTGCC
TCTGTTTTTTGCCCACACTATCATTCACGA|ACGGGGTCGTATGCACAGACATTATGTGCG
GCGAGTCTGTTTTTTGCCCACATGATCTGG|GTGACTTTCGGGTCCTAGCGAGTCCGGGTC
TGATCGATTCCGCTACGGGGTCGTATGCAC|CCATAACCCTCAGTTTGACGCGAAATAACT
CTATTACCGCATAATTTTCAACAAAGCGCA|GTCTCATTTATATTCGGGTCCTAGCGAGTC
ACCATATCACGTTTGGTCAAACGGGCATTA|ATGCGGCATTGATCATTCGCTCCCGTTGCC
CGGTATGATATCTAGGAGCGGGTCCCGGGT|GTCGGTAGAACATGCTGATACTGGCCACTC
GTCCTAGCGAGTCTGTTTTTTGCCCACCCA|TGTTTTTTGCCCACCATATCACGTTTGGTC
GCGAGTCCGGGTCCTAGCGAGTCTGTTTTT|AGCGGGTCCTAGCGAGTCTGTTTTTTGCCC
TATCTAGGAGCGGGTCCCGGGTCCTAGCGA|AACATGCTGATACTGGCCACTCTACATGAA
GATGTGACGATCCGTCACGATCAGCCGCTG|TACTTGCCTTTCCCTAGGTCGATCGAGAAT
CAGTTGCTTCGGATACAGGATGTGCGCTTA|AGGCTTGCTCCGGACGTACTGACTGGTTAG
TGTCGGTAGAACATGCTGATACTGGCCACT|ATCAGCCGCTGCACCGTGATATTAAGAACA
GTATTCAAGTGAAATCTGAGTACTTTCCGG|GGCTCGGGTCCTAGCGAGTCTGTTTTTTGC
TGCGGGTCCTAGCGAGTCTGTTTTTTGCCC|GTCTGTTTTTTGCCCACCCACGGCGCCGGG
TCTGTTTTTTGCCCACGTATCCCAAAGGAG|CACACGGCAGGAACGGCGCCAGCGATCGGC
GTATGGTCTCATTTATATTCGGGTCCTAGC|TCTGACATCGACAGAAATTCTTGCGACCTT
CATAATTTTCAACAAAGCGCACGTCCACTA|ATATTCGGGTCCTAGCGAGTCTGTTTTTTG
CTAATACCAGTTTCCTCTGACTTTAAACCT|CGTACCTGTTAATCGTCCCGCTGCCCCGCG
CACTAGCGAGTCTGTTTTTTGCCCACACTA|CGATTCCGCTACGGGGTCGTATGCACAGAC
CCGTTGCCGGGTCCTAGCGAGTCTGTTTTT|TTTTTGCCCACCCCAAAACCTCACACGGCA
TACCGCATAATTTTCAACAAAGCGCACGTC|CATTTATATTCGGGTCCTAGCGAGTCTGTT
CGTTTGGTCAAACGGGCATTACGATAACAA|TGATCATTCGCTCCCGTTGCCGGGTCCTAG
CGCAGCAGGAAGCTCACAGTTGCTTCGGAT|TCATTCACGATGCAAAAGGCTTGCTCCGGA
TCTCTCCGTTGCTATTACCGCATAATTTTC|GCACTTGTATGGTCTCATTTATATTCGGGT
ATTTTCAACAAAGCGCACGTCCACTACCTG|TCGGGTCCTAGCGAGTCTGTTTTTTGCCCA
CAGCTGATCGATTCCGCTACGGGGTCGTAT|TTGCCCATAACCCTCAGTTTGACGCGAAAT
ACTTTAAACCTCCCCTTGACCGTGAGACTG|GCTGCCCCGCGTCCGGTGCGAAGCACCGCG
ACTGTATCCGAATCACGTTACAAGAATAAC|CGCGAGTCTCGATGCTGAATGGGTTAGGGA
TTTTTTGCCCACGGGTCCTAGCGAGTCTGT|CTAGCCGTATGCCCTAGACAGTGACTTTCG
CCGCGTCAGCTGATCGATTCCGCTACGGGG|GTAAGTTTGCCCATAACCCTCAGTTTGACG
CTTCGCAGCAGGAAGCTCACAGTTGCTTCG|CTATCATTCACGATGCAAAAGGCTTGCTCC
TGGATCCACTTTTCGGGTCCTAGCGAGTCT|GTCCTAGCGAGTCTGTTTTTTGCCCACTGT
CTGCGGGTCCTAGCGAGTCTGTTTTTTGCC|AGTCTGTTTTTTGCCCACCCACGGCGCCGG
ACACGGCAGGAACGGCGCCAGCGATCGGCA|AGTTTCCTCTGACTTTAAACCTCCCCTTGA
TACGGGGTCGTATGCACAGACATTATGTGC|TTTGACGCGAAATAACTGTATATGTCTTCT
TTTTTGCCCACTTTTTTGCCCACTACTTAT|GGCGCCGGGTCCTAGCGAGTCTGTTTTTTG
AGTTTCCTCTGACTTTAAACCTCCCCTTGA|TTAATCGTCCCGCTGCCCCGCGTCCGGTGC
GTCCTAGCGAGTCTGTTTTTTGCCCACGTA|GCGACCTTCGCAGCAGGAAGCTCACAGTTG
TTTTTGCCCACCTCGCCTGACGTTCATCTA|ACAAGATGTAGCTCTCTCCGTTGCTATTAC
TGCGTGCTCTTAGTCCTCTCCAGATGTGAC|TCTCCAAACTACGTCCTACTAGTACTTGCC
CGGGTCCTAGCGAGTCTGTTTTTTGCCCAC|ATAATTTTCAACAAAGCGCACGTCCACTAC
TTGCCCACTACTTATAAGCGCCTTCGTCGG|CGAGTCTGTTTTTTGCCCACGGGTCCTAGC
CACACGGCAGGAACGGCGCCAGCGATCGGC|CAGTTTCCTCTGACTTTAAACCTCCCCTTG
AGGAACGGCGCCAGCGATCGGCAGTGACGT|TCTGACTTTAAACCTCCCCTTGACCGTGAG
GACCCATAGCGTATTCAAGTGAAATCTGAG|CTTGTCCGTTGGCTCGGGTCCTAGCGAGTC
GTCCTAGCGAGTCTGTTTTTTGCCCACATG|TAGACAGTGACTTTCGGGTCCTAGCGAGTC
TTCGGATACAGGATGTGCGCTTAGGCGGTA|CTCCGGACGTACTGACTGGTTAGTTGTCGG
CCTCTCCAGATGTGACGATCCGTCACGATC|CCTACTAGTACTTGCCTTTCCCTAGGTCGA
CATGAACCGCGTCAGCTGATCGATTCCGCT|TGCTAAGTAAGTTTGCCCATAACCCTCAGT
GTTTTTTGCCCACTTTTTTGCCCACTACTT|ACGGCGCCGGGTCCTAGCGAGTCTGTTTTT
AGTCTGTTTTTTGCCCACACTATCATTCAC|CTACGGGGTCGTATGCACAGACATTATGTG
ACATGAACCGCGTCAGCTGATCGATTCCGC|ATGCTAAGTAAGTTTGCCCATAACCCTCAG
GCGAGTCTGTTTTTTGCCCACGTACCTGTT|TTCGCAGCAGGAAGCTCACAGTTGCTTCGG
AGAATAACTGCACTTGTATGGTCTCATTTA|GTTAGGGAAAGGAAATCTGACATCGACAGA
GTTTTTTGCCCACGGGTCCTAGCGAGTCTG|ACTAGCCGTATGCCCTAGACAGTGACTTTC
GTCCTAGCGAGTCTGTTTTTTGCCCACTTT|TTTTTTGCCCACCCACGGCGCCGGGTCCTA
AAACCTCCCCTTGACCGTGAGACTGTATCC|CCCGCGTCCGGTGCGAAGCACCGCGAGTCT
GCCGGGTCCTAGCGAGTCTGTTTTTTGCCC|GGGCATTACGATAACAACTACTAGCCGTAT
ACATTATGTGCGTGCTCTTAGTCCTCTCCA|ATATGTCTTCTCCAAACTACGTCCTACTAG
TTGTCCGTTGGCTCGGGTCCTAGCGAGTCT|TGCCCACATGATCTGGATCCACTTTTCGGG
GGTGCGAAGCACCGCGAGTCTCGATGCTGA|TATGATATCTAGGAGCGGGTCCCGGGTCCT
CCCGGGTCCTAGCGAGTCTGTTTTTTGCCC|GCCACTCTACATGAACCGCGTCAGCTGATC
ATCGTAATGCTAATACAAGATGTAGCTCTC|ATCCGAATCACGTTACAAGAATAACTGCAC
CTCCAGATGTGACGATCCGTCACGATCAGC|ACTAGTACTTGCCTTTCCCTAGGTCGATCG
CGATGCAAAAGGCTTGCTCCGGACGTACTG|GCGTGCTCTTAGTCCTCTCCAGATGTGACG
GTCTGTTTTTTGCCCACCCACGGCGCCGGG|CCACCATATCACGTTTGGTCAAACGGGCAT
ATCGGCAGTGACGTTCCTAATCGTAATGCT|CCCTTGACCGTGAGACTGTATCCGAATCAC
GTTTCCTCTGACTTTAAACCTCCCCTTGAC|TAATCGTCCCGCTGCCCCGCGTCCGGTGCG
ATCTAGGAGCGGGTCCCGGGTCCTAGCGAG|ACATGCTGATACTGGCCACTCTACATGAAC
CACTCTACATGAACCGCGTCAGCTGATCGA|AACAATATGCTAAGTAAGTTTGCCCATAAC
CCGGGTCCTAGCGAGTCTGTTTTTTGCCCA|CCACTCTACATGAACCGCGTCAGCTGATCG
ATGTGCGTGCTCTTAGTCCTCTCCAGATGT|TCTTCTCCAAACTACGTCCTACTAGTACTT
CCACACTATCATTCACGATGCAAAAGGCTT|GCACAGACATTATGTGCGTGCTCTTAGTCC
GCAGCAGGAAGCTCACAGTTGCTTCGGATA|CATTCACGATGCAAAAGGCTTGCTCCGGAC
GCGCCGGGTCCTAGCGAGTCTGTTTTTTGC|ACGGGCATTACGATAACAACTACTAGCCGT
ATACCAGTTTCCTCTGACTTTAAACCTCCC|ACCTGTTAATCGTCCCGCTGCCCCGCGTCC
GAAGCACCGCGAGTCTCGATGCTGAATGGG|TATCTAGGAGCGGGTCCCGGGTCCTAGCGA
GCTGATCGATTCCGCTACGGGGTCGTATGC|GCCCATAACCCTCAGTTTGACGCGAAATAA
GACATCGACAGAAATTCTTGCGACCTTCGC|TAGCGAGTCTGTTTTTTGCCCACACTATCA
GTTTTTTGCCCACCCCAAAACCTCACACGG|GCACGTCCACTACCTGCTAATACCAGTTTC
CGCCAGCGATCGGCAGTGACGTTCCTAATC|TAAACCTCCCCTTGACCGTGAGACTGTATC
TCAGCTGATCGATTCCGCTACGGGGTCGTA|TTTGCCCATAACCCTCAGTTTGACGCGAAA
TGCTAATACAAGATGTAGCTCTCTCCGTTG|TCACGTTACAAGAATAACTGCACTTGTATG
GCATAATTTTCAACAAAGCGCACGTCCACT|TATATTCGGGTCCTAGCGAGTCTGTTTTTT
TACTGGCCACTCTACATGAACCGCGTCAGC|TATTAAGAACAATATGCTAAGTAAGTTTGC
ATAAGCGCCTTCGTCGGCTGGGCCGTACCT|TGCCCACGGGTCCTAGCGAGTCTGTTTTTT
TTCCGCTACGGGGTCGTATGCACAGACATT|CCTCAGTTTGACGCGAAATAACTGTATATG
CCGCGTCCGGTGCGAAGCACCGCGAGTCTC|TTAGGCGGTATGATATCTAGGAGCGGGTCC
CACACTATCATTCACGATGCAAAAGGCTTG|CACAGACATTATGTGCGTGCTCTTAGTCCT
TCCGTTGGCTCGGGTCCTAGCGAGTCTGTT|CCACATGATCTGGATCCACTTTTCGGGTCC
CCCCTTGACCGTGAGACTGTATCCGAATCA|TCCGGTGCGAAGCACCGCGAGTCTCGATGC
TCACACGGCAGGAACGGCGCCAGCGATCGG|CCAGTTTCCTCTGACTTTAAACCTCCCCTT
AACGGGCATTACGATAACAACTACTAGCCG|CTCCCGTTGCCGGGTCCTAGCGAGTCTGTT
GCACGTCCACTACCTGCTAATACCAGTTTC|GTCTGTTTTTTGCCCACGTACCTGTTAATC
GCTGCCCCGCGTCCGGTGCGAAGCACCGCG|GTGCGCTTAGGCGGTATGATATCTAGGAGC
GCCCACCCCAAAACCTCACACGGCAGGAAC|CACTACCTGCTAATACCAGTTTCCTCTGAC
AAGTGAAATCTGAGTACTTTCCGGGTCCTA|GGTCCTAGCGAGTCTGTTTTTTGCCGGGTC
AGCGAGTCTGTTTTTTGCCCACCCACGGCG|TTTGCCCACCATATCACGTTTGGTCAAACG
ACTTTTTTGCCCACTACTTATAAGCGCCTT|TCCTAGCGAGTCTGTTTTTTGCCCACGGGT
TGCTATTACCGCATAATTTTCAACAAAGCG|TGGTCTCATTTATATTCGGGTCCTAGCGAG
TCCTAGCGAGTCTGCGGGTCCTAGCGAGTC|GGGTCCTAGCGAGTCTGTTTTTTGCCCACC
GCTATTACCGCATAATTTTCAACAAAGCGC|GGTCTCATTTATATTCGGGTCCTAGCGAGT
TCTAGGAGCGGGTCCCGGGTCCTAGCGAGT|CATGCTGATACTGGCCACTCTACATGAACC
TATGTGCGTGCTCTTAGTCCTCTCCAGATG|GTCTTCTCCAAACTACGTCCTACTAGTACT
ACCGCGTCAGCTGATCGATTCCGCTACGGG|AGTAAGTTTGCCCATAACCCTCAGTTTGAC
TGTATGGTCTCATTTATATTCGGGTCCTAG|ATCTGACATCGACAGAAATTCTTGCGACCT
GATGCAAAAGGCTTGCTCCGGACGTACTGA|CGTGCTCTTAGTCCTCTCCAGATGTGACGA
CCTAGCGAGTCTGTTTTTTGCCCACGTACC|GACCTTCGCAGCAGGAAGCTCACAGTTGCT
GGCTGGGCCGTACCTTGTCCGTTGGCTCGG|GCGAGTCTGTTTTTTGCCCACATGATCTGG
CTGACGTTCATCTACAACGGGTCCTAGCGA|TCCGTTGCTATTACCGCATAATTTTCAACA
CACGTTTGGTCAAACGGGCATTACGATAAC|ATTGATCATTCGCTCCCGTTGCCGGGTCCT
TTTGCCCACATGATCTGGATCCACTTTTCG|TCCTAGCGAGTCCGGGTCCTAGCGAGTCTG
GCGAGTCTGTTTTTTGCCCACTAGCGAGTC|TGAACCGCGTCAGCTGATCGATTCCGCTAC
TGCCCACATGATCTGGATCCACTTTTCGGG|CTAGCGAGTCCGGGTCCTAGCGAGTCTGTT
CCGAATCACGTTACAAGAATAACTGCACTT|CTCGATGCTGAATGGGTTAGGGAAAGGAAA
CACTACCTGCTAATACCAGTTTCCTCTGAC|TTTTGCCCACGTACCTGTTAATCGTCCCGC
CAGTTTCCTCTGACTTTAAACCTCCCCTTG|GTTAATCGTCCCGCTGCCCCGCGTCCGGTG
TTATATTCGGGTCCTAGCGAGTCTGTTTTT|AGAAATTCTTGCGACCTTCGCAGCAGGAAG
CGAAGCACCGCGAGTCTCGATGCTGAATGG|ATATCTAGGAGCGGGTCCCGGGTCCTAGCG
